Death in the Afternoon	COCKTAIL.ABSINTHE
Earthquake	COCKTAIL.ABSINTHE
Green Russians	COCKTAIL.ABSINTHE
Green Vesper	COCKTAIL.ABSINTHE
Moloko Plus	COCKTAIL.ABSINTHE
Black and Tan	COCKTAIL.BEER
Black Velvet	COCKTAIL.BEER
Boilermaker	COCKTAIL.BEER
Hangman's Blood	COCKTAIL.BEER
Irish Car Bomb	COCKTAIL.BEER
Michelada	COCKTAIL.BEER
Porchcrawler	COCKTAIL.BEER
Sake Bomb	COCKTAIL.BEER
Shandy	COCKTAIL.BEER
Snakebite	COCKTAIL.BEER
U-Boot	COCKTAIL.BEER
B & B	COCKTAIL.BRANDY
The Blenheim	COCKTAIL.BRANDY
Brandy Alexander	COCKTAIL.BRANDY
Brandy Manhattan	COCKTAIL.BRANDY
Brandy Sour	COCKTAIL.BRANDY
Brandy Sour	COCKTAIL.BRANDY
Chicago Cocktail	COCKTAIL.BRANDY
Curacao Punch	COCKTAIL.BRANDY
Four Score	COCKTAIL.BRANDY
French Connection	COCKTAIL.BRANDY
Hennchata	COCKTAIL.BRANDY
Horse's Neck 	COCKTAIL.BRANDY
Incredible Hulk	COCKTAIL.BRANDY
Jack Rose	COCKTAIL.BRANDY
Nikolaschka	COCKTAIL.BRANDY
Orgasm	COCKTAIL.BRANDY
Panama	COCKTAIL.BRANDY
Paradise 	COCKTAIL.BRANDY
Pisco Sour	COCKTAIL.BRANDY
Porto flip	COCKTAIL.BRANDY
Savoy Affair	COCKTAIL.BRANDY
Savoy Corpse Reviver	COCKTAIL.BRANDY
Sazerac	COCKTAIL.BRANDY
Sidecar	COCKTAIL.BRANDY
Singapore Sling 	COCKTAIL.BRANDY
Stinger	COCKTAIL.BRANDY
Tom and Jerry	COCKTAIL.BRANDY
Zombie	COCKTAIL.BRANDY
Batida	COCKTAIL.CACHACA
Caipirinha	COCKTAIL.CACHACA
Caju Amigo	COCKTAIL.CACHACA
Leite de On�a	COCKTAIL.CACHACA
Quent�o	COCKTAIL.CACHACA
Rabo-de-galo	COCKTAIL.CACHACA
Royce	COCKTAIL.CACHACA
Bramble	COCKTAIL.GIN
Alexander	COCKTAIL.GIN
Angel Face	COCKTAIL.GIN
Aviation	COCKTAIL.GIN
Bee's Knees	COCKTAIL.GIN
Bijou	COCKTAIL.GIN
Bloodhound	COCKTAIL.GIN
Breakfast martini	COCKTAIL.GIN
Bronx	COCKTAIL.GIN
Casino 	COCKTAIL.GIN
Clover Club	COCKTAIL.GIN
Corpse Reviver #2	COCKTAIL.GIN
Damn the Weather	COCKTAIL.GIN
French 75	COCKTAIL.GIN
Derby	COCKTAIL.GIN
Gibson	COCKTAIL.GIN
Gimlet	COCKTAIL.GIN
Gin and tonic	COCKTAIL.GIN
Gin buck	COCKTAIL.GIN
Gin Fizz	COCKTAIL.GIN
Gin pahit	COCKTAIL.GIN
Gin Sour	COCKTAIL.GIN
Greyhound	COCKTAIL.GIN
Hanky-Panky	COCKTAIL.GIN
John Collins	COCKTAIL.GIN
The Last Word	COCKTAIL.GIN
Lime Rickey	COCKTAIL.GIN
London Fog	COCKTAIL.GIN
Long Island Iced Tea	COCKTAIL.GIN
Lorraine	COCKTAIL.GIN
Martini 	COCKTAIL.GIN
Mickey Slim	COCKTAIL.GIN
Monkey Gland	COCKTAIL.GIN
My Fair Lady	COCKTAIL.GIN
Negroni	COCKTAIL.GIN
Old Etonian	COCKTAIL.GIN
Pall Mall	COCKTAIL.GIN
Paradise	COCKTAIL.GIN
Pegu	COCKTAIL.GIN
Pimm's Cup	COCKTAIL.GIN
Pink Gin	COCKTAIL.GIN
Pink Lady	COCKTAIL.GIN
Ramos Gin Fizz	COCKTAIL.GIN
Royal Arrival	COCKTAIL.GIN
Salty Dog	COCKTAIL.GIN
Shirley Temple Black	COCKTAIL.GIN
Singapore Sling	COCKTAIL.GIN
Tom Collins	COCKTAIL.GIN
Tuxedo	COCKTAIL.GIN
Vesper Martini	COCKTAIL.GIN
White Lady or Delilah	COCKTAIL.GIN
Wolfram	COCKTAIL.GIN
Bacardi 	COCKTAIL.RUM
Between the Sheets	COCKTAIL.RUM
Blue Hawaii	COCKTAIL.RUM
Brass Monkey	COCKTAIL.RUM
Bumbo	COCKTAIL.RUM
Bushwacker	COCKTAIL.RUM
Caribou Lou	COCKTAIL.RUM
Cojito	COCKTAIL.RUM
Corn N' Oil	COCKTAIL.RUM
Cuba Libre	COCKTAIL.RUM
Culto A La Vida	COCKTAIL.RUM
Daiquiri 	COCKTAIL.RUM
Dark 'N' Stormy	COCKTAIL.RUM
Dark & Stormy	COCKTAIL.RUM
Dark Stormy	COCKTAIL.RUM
Dark and Stormy	COCKTAIL.RUM
El Presidente	COCKTAIL.RUM
Fish House Punch	COCKTAIL.RUM
Flaming Dr Pepper	COCKTAIL.RUM
Flaming Volcano	COCKTAIL.RUM
Fluffy Critter	COCKTAIL.RUM
The Goldeneye	COCKTAIL.RUM
Grog	COCKTAIL.RUM
Gunfire	COCKTAIL.RUM
Havana Cooler	COCKTAIL.RUM
Hot buttered rum	COCKTAIL.RUM
Hurricane	COCKTAIL.RUM
Jagertee	COCKTAIL.RUM
Long Island Iced Tea	COCKTAIL.RUM
Macu�	COCKTAIL.RUM
Mai-Tai	COCKTAIL.RUM
Mojito	COCKTAIL.RUM
Painkiller	COCKTAIL.RUM
Pi�a Colada	COCKTAIL.RUM
Planter's Punch	COCKTAIL.RUM
Royal Bermuda Cocktail	COCKTAIL.RUM
Rum Swizzle	COCKTAIL.RUM
Staten Island Ferry	COCKTAIL.RUM
Sundowner	COCKTAIL.RUM
Ti' Punch	COCKTAIL.RUM
Tom and Jerry	COCKTAIL.RUM
Tschunk	COCKTAIL.RUM
Yellow Bird	COCKTAIL.RUM
Zombie	COCKTAIL.RUM
Ginza Mary	COCKTAIL.SAKE
Sake Bomb	COCKTAIL.SAKE
Tamagozake	COCKTAIL.SAKE
Bananarita	COCKTAIL.TEQUILLA
Bloody Aztec	COCKTAIL.TEQUILLA
Chimay� Cocktail	COCKTAIL.TEQUILLA
El Toro Loco Patron and Redbull	COCKTAIL.TEQUILLA
Juan Collins	COCKTAIL.TEQUILLA
Long Island Iced Tea  IBA 	COCKTAIL.TEQUILLA
Margarita  IBA 	COCKTAIL.TEQUILLA
Matador	COCKTAIL.TEQUILLA
Paloma	COCKTAIL.TEQUILLA
Slammer Royale	COCKTAIL.TEQUILLA
Tequila Slammer	COCKTAIL.TEQUILLA
Tequila and Tonic	COCKTAIL.TEQUILLA
Tequila Sour	COCKTAIL.TEQUILLA
Tequila Sunrise	COCKTAIL.TEQUILLA
Agent Orange	COCKTAIL.VODKA
Anita Bryant	COCTAIL.VODKA
Apple Martini	COCKTAIL.VODKA
Appletini	COCKTAIL.VODKA
Astro pop	COCKTAIL.VODKA
Baby Tornado  COCKTAIL.VODKA
Batida	COCKTAIL.VODKA
Bay Breeze	COCKTAIL.VODKA
Black Russian	COCKTAIL.VODKA
Bloody Mary	COCKTAIL.VODKA
BLT cocktail	COCKTAIL.VODKA
Blue Lagoon	COCKTAIL.VODKA
Bull Shot	COCKTAIL.VODKA
Caesar	COCKTAIL.VODKA
Caipivodka	COCKTAIL.VODKA
Caipiroska	COCKTAIL.VODKA
Cape Cod	COCKTAIL.VODKA
Chi-Chi	COCKTAIL.VODKA
Colombia	COCKTAIL.VODKA
Cosmopolitan	COCKTAIL.VODKA
Fizzy apple cocktail	COCKTAIL.VODKA
Flirtini	COCKTAIL.VODKA
Gimlet	COCKTAIL.VODKA
Glowtini	COCKTAIL.VODKA
Godmother	COCKTAIL.VODKA
The Goldeneye	COCKTAIL.VODKA
Harrogate Nights	COCKTAIL.VODKA
Harvey Wallbanger	COCKTAIL.VODKA
Hi-fi	COCKTAIL.VODKA
Kamikaze	COCKTAIL.VODKA
Kensington Court Special	COCKTAIL.VODKA
Kremlin Colonel	COCKTAIL.VODKA
Lemon Drop	COCKTAIL.VODKA
Lime Rickey	COCKTAIL.VODKA
Link Up	COCKTAIL.VODKA
Long Island Iced Tea	COCKTAIL.VODKA
Moscow Mule	COCKTAIL.VODKA
Mudslide	COCKTAIL.VODKA
Orange Tundra	COCKTAIL.VODKA
Paralyzer	COCKTAIL.VODKA
Red Lotus	COCKTAIL.VODKA
Red Russian	COCKTAIL.VODKA
Rose Kennedy Cocktail	COCKTAIL.VODKA
Salmiakki Koskenkorva	COCKTAIL.VODKA
Salty Dog	COCKTAIL.VODKA
Screwdriver	COCKTAIL.VODKA
Sea Breeze	COCKTAIL.VODKA
Sex on the Beach	COCKTAIL.VODKA
Titty Twister	COCKTAIL.VODKA
Vesper	COCKTAIL.VODKA
Vodka Gimlet	COCKTAIL.VODKA
Vodka Martini	COCKTAIL.VODKA
Vodka McGovern	COCKTAIL.VODKA
Vodka Sundowner	COCKTAIL.VODKA
Vodka Sunrise	COCKTAIL.VODKA
White Russian	COCKTAIL.VODKA
Woo Woo	COCKTAIL.VODKA
Yorsh	COCKTAIL.VODKA
Amber Moon	COCKTAIL.WHISKEY
Blue Blazer	COCKTAIL.WHISKEY
Bobby Burns	COCKTAIL.WHISKEY
Boulevardier	COCKTAIL.WHISKEY
Bourbon Lancer	COCKTAIL.WHISKEY
Brooklyn	COCKTAIL.WHISKEY
Churchill	COCKTAIL.WHISKEY
Farnell	COCKTAIL.WHISKEY
Four Horsemen	COCKTAIL.WHISKEY
Irish Coffee 	COCKTAIL.WHISKEY
Jack and Coke	COCKTAIL.WHISKEY
Jungle Juice	COCKTAIL.WHISKEY
Lynchburg Lemonade	COCKTAIL.WHISKEY
Manhattan	COCKTAIL.WHISKEY
Mint Julep	COCKTAIL.WHISKEY
Missouri Mule	COCKTAIL.WHISKEY
Nixon	COCKTAIL.WHISKEY
Old Fashioned	COCKTAIL.WHISKEY
Rob Roy	COCKTAIL.WHISKEY
Rusty Nail	COCKTAIL.WHISKEY
Sazerac	COCKTAIL.WHISKEY
Seven and Seven	COCKTAIL.WHISKEY
7 & 7	COCKTAIL.WHISKEY
Three Wise Men	COCKTAIL.WHISKEY
Ward 8	COCKTAIL.WHISKEY
Whisky Mac	COCKTAIL.WHISKEY
Whiskey sour	COCKTAIL.WHISKEY
Agua de Valencia	COCKTAIL.WINE
Black Velvet	COCKTAIL.WINE
Death in the Afternoon	COCKTAIL.WINE
Flirtini	COCKTAIL.WINE
Prince of Wales	COCKTAIL.WINE
Sangria	COCKTAIL.WINE
Agua de Sevilla	COCKTAIL.SPARKLING
Aperol Spritz	COCKTAIL.SPARKLING
Bellini	COCKTAIL.SPARKLING
Rossini	COCKTAIL.SPARKLING
Black Velvet	COCKTAIL.CHAMPAIGN
Buck's Fizz	COCKTAIL.CHAMPAIGN
Champagne Cocktail	COCKTAIL.CHAMPAIGN
French 75	COCKTAIL.CHAMPAIGN
Kir Royal	COCKTAIL.CHAMPAIGN
Mimosa	COCKTAIL.CHAMPAIGN
Ruby Dutchess	COCKTAIL.CHAMPAIGN
B-52	COCKTAIL.LIQUER
Baby Guinness	COCKTAIL.LIQUER
Black Russian	COCKTAIL.LIQUER
Blow Job	COCKTAIL.LIQUER
Duck Fart	COCKTAIL.LIQUER
Orgasm	COCKTAIL.LIQUER
B-52	COCKTAIL.LIQUER
Baby Guinness	COCKTAIL.LIQUER
Buttery Nipple	COCKTAIL.LIQUER
Irish Car Bomb	COCKTAIL.LIQUER
Oatmeal Cookie	COCKTAIL.LIQUER
Orgasm	COCKTAIL.LIQUER
Quick Fuck	COCKTAIL.LIQUER
Slippery Nipple	COCKTAIL.LIQUER
Springbokkie	COCKTAIL.LIQUER
Grasshopper	COCKTAIL.LIQUER
Springbokkie	COCKTAIL.LIQUER
Apple-Kneel	COCKTAIL.LIQUER
Apple Kneel	COCKTAIL.LIQUER
Golden Doublet	COCKTAIL.LIQUER
Golden Dream	COCKTAIL.LIQUER
Moonwalk	COCKTAIL.LIQUER
Skittle Bomb	COCKTAIL.LIQUER
Japanese Slipper	COCKTAIL.LIQUER
Midori Sour	COCKTAIL.LIQUER
Sambuca	COCKTAIL.LIQUER
Herbsaint Frapp�	COCKTAIL.LIQUER
Mauresque	COCKTAIL.LIQUER
Perroquet	COCKTAIL.LIQUER
Rourou	COCKTAIL.LIQUER
Tomate	COCKTAIL.LIQUER
Alabama Slammer	COCKTAIL.LIQUER
Blueberry Tea	COCKTAIL.LIQUER
French Connection	COCKTAIL.LIQUER
Godfather	COCKTAIL.LIQUER
Godmother	COCKTAIL.LIQUER
Orgasm	COCKTAIL.LIQUER
Rusty Nail	COCKTAIL.LIQUER
Backdraft	COCKTAIL.LIQUER
Carrot Cake	COCKTAIL.LIQUER
Common Market	COCKTAIL.LIQUER
Flaming Sambuca	COCKTAIL.LIQUER
J�gerbomb	COCKTAIL.LIQUER
Orange Safari	COCKTAIL.LIQUER
Appletini	COCKTAIL.LIQUER
Fuzzy Navel	COCKTAIL.LIQUER
Polar Bear	COCKTAIL.LIQUER
Redheaded slut	COCKTAIL.LIQUER
Aguaymanto Sour	COCKTAIL.LIQUER
Jazmin Sour	COCKTAIL.LIQUER
Mango Sour	COCKTAIL.LIQUER
Pisco Sour	COCKTAIL.LIQUER
Americano  IBA 	COCKTAIL.LIQUER
Brut Cocktail	COCKTAIL.LIQUER
Bourbon whiskey	WHISKEY
Corn whiskey	WHISKEY
Malt whiskey	WHISKEY
Rye whiskey	WHISKEY
Rye malt whiskey	WHISKEY
Wheat whiskey	WHISKEY
Malt whisky	WHISKEY
Grain whisky	WHISKEY
Single malt whisky 	WHISKEY
Blended malt whisky	WHISKEY
vatted malt whisky	WHISKEY
Blended whisky	WHISKY
Canadian whisky	WHISKY
Single cask whisky	WHISKY
Single barrel whisky	WHISKEY
Whiskey	WHISKEY
Whisky	WHISKY
Rum	RUM
Dark Rum	RUM
Flavored Rum	RUM
Banana Rum	RUM
Mango Rum	RUM
Orange Rum	RUM
Pineapple Rum	RUM
Coconut Rum	RUM
Lime Rum	RUM
Gold Rum	RUM
Light Rum	RUM
Spiced Rum	RUM
Rhum	RUM
Gin	GIN
Distilled Gin	GIN
London Gin	GIN
Brandy	BRANDY
American Brandy	BRANDY
Armagnac	BRANDY
Cognac	BRANDY
Cyprus brandy	BRANDY
Kanyak 	BRANDY
konyak	BRANDY
Pisco 	BRANDY
Italian Stravecchio 	BRANDY
Beer	BEER
Pale ale	BEER
Indian Pale ale 	BEER
IPA	BEER
Porter	BEER
Bock	BEER
Brown Ale	BEER
Pale Lager	BEER
Lambic	BEER
Marzen	BEER
Saison	BEER
Kolsh	BEER
Dunkel	BEER
Duvel	BEER
Tripel	BEER
Helles	BEER
Cream ale	BEER
Schwarzier	BEER
Berliner Weisse	BEER
Dubbel	BEER
Geuze	BEER
Steam beer	BEER
American pale ale	BEER
Gose	BEER
Cask ale	BEER
Rye beer	BEER
Trappist beer	BEER
American lager	BEER
Quadrupel	BEER
Scotch ale	BEER
Amber Ale	BEER
stout	BEER
wheat beer	BEER
Lager	BEER
Malt Liquor	BEER
Cider	CIDER
