Agung a Tamlang	MUSICAL_INSTRUMENT.PERCUSSION
Bamboo slit drum	MUSICAL_INSTRUMENT.PERCUSSION
Balafon	MUSICAL_INSTRUMENT.PERCUSSION
Cajon	MUSICAL_INSTRUMENT.PERCUSSION
Castanet	MUSICAL_INSTRUMENT.PERCUSSION
Clapstick	MUSICAL_INSTRUMENT.PERCUSSION
Glockenspiel	MUSICAL_INSTRUMENT.PERCUSSION
Handpan	MUSICAL_INSTRUMENT.PERCUSSION
Mbira	MUSICAL_INSTRUMENT.PERCUSSION
Marimba	MUSICAL_INSTRUMENT.PERCUSSION
Stellpan	MUSICAL_INSTRUMENT.PERCUSSION
Triangle	MUSICAL_INSTRUMENT.PERCUSSION
Vibraphone	MUSICAL_INSTRUMENT.PERCUSSION
Wood block	MUSICAL_INSTRUMENT.PERCUSSION
Xylophone	MUSICAL_INSTRUMENT.PERCUSSION
Agida	MUSICAL_INSTRUMENT.MEMBRANOPHONES
Alcahuete	MUSICAL_INSTRUMENT.MEMBRANOPHONES
Apinti	MUSICAL_INSTRUMENT.MEMBRANOPHONES
Arobap�	MUSICAL_INSTRUMENT.MEMBRANOPHONES
Ashiko	MUSICAL_INSTRUMENT.MEMBRANOPHONES
Assotor	MUSICAL_INSTRUMENT.MEMBRANOPHONES
Baboula	MUSICAL_INSTRUMENT.MEMBRANOPHONES
Balaban	MUSICAL_INSTRUMENT.MEMBRANOPHONES
Balsi�	MUSICAL_INSTRUMENT.MEMBRANOPHONES
Bamboula	MUSICAL_INSTRUMENT.MEMBRANOPHONES
Bari	MUSICAL_INSTRUMENT.MEMBRANOPHONES
Barrel drum	MUSICAL_INSTRUMENT.MEMBRANOPHONES
Barriles	MUSICAL_INSTRUMENT.MEMBRANOPHONES
Bass drum	MUSICAL_INSTRUMENT.MEMBRANOPHONES
Bodhran	MUSICAL_INSTRUMENT.MEMBRANOPHONES
Bongo drums	MUSICAL_INSTRUMENT.MEMBRANOPHONES
Boodam	MUSICAL_INSTRUMENT.MEMBRANOPHONES
Candombe	MUSICAL_INSTRUMENT.MEMBRANOPHONES
Chenda	MUSICAL_INSTRUMENT.MEMBRANOPHONES
Conga	MUSICAL_INSTRUMENT.MEMBRANOPHONES
Cuica	MUSICAL_INSTRUMENT.MEMBRANOPHONES
Dabakan	MUSICAL_INSTRUMENT.MEMBRANOPHONES
Daf	MUSICAL_INSTRUMENT.MEMBRANOPHONES
Davul	MUSICAL_INSTRUMENT.MEMBRANOPHONES
Dhaa	MUSICAL_INSTRUMENT.MEMBRANOPHONES
Dhimay	MUSICAL_INSTRUMENT.MEMBRANOPHONES
Dhol	MUSICAL_INSTRUMENT.MEMBRANOPHONES
Dholak	MUSICAL_INSTRUMENT.MEMBRANOPHONES
Dimdi	MUSICAL_INSTRUMENT.MEMBRANOPHONES
Djembe	MUSICAL_INSTRUMENT.MEMBRANOPHONES
Dollu	MUSICAL_INSTRUMENT.MEMBRANOPHONES
Dunun	MUSICAL_INSTRUMENT.MEMBRANOPHONES
Drum kit	MUSICAL_INSTRUMENT.MEMBRANOPHONES
Gran Cassa	MUSICAL_INSTRUMENT.MEMBRANOPHONES
Goblet drum	MUSICAL_INSTRUMENT.MEMBRANOPHONES
Hira-daiko	MUSICAL_INSTRUMENT.MEMBRANOPHONES
Ilimba drum	MUSICAL_INSTRUMENT.MEMBRANOPHONES
Ingoma	MUSICAL_INSTRUMENT.MEMBRANOPHONES
Janggu	MUSICAL_INSTRUMENT.MEMBRANOPHONES
Kakko	MUSICAL_INSTRUMENT.MEMBRANOPHONES
Kanjira	MUSICAL_INSTRUMENT.MEMBRANOPHONES
Kendang	MUSICAL_INSTRUMENT.MEMBRANOPHONES
Khol	MUSICAL_INSTRUMENT.MEMBRANOPHONES
Lambeg drum	MUSICAL_INSTRUMENT.MEMBRANOPHONES
Madhalam	MUSICAL_INSTRUMENT.MEMBRANOPHONES
Madal	MUSICAL_INSTRUMENT.MEMBRANOPHONES
Maddale	MUSICAL_INSTRUMENT.MEMBRANOPHONES
Maktoum	MUSICAL_INSTRUMENT.MEMBRANOPHONES
Mridangam	MUSICAL_INSTRUMENT.MEMBRANOPHONES
Naqara	MUSICAL_INSTRUMENT.MEMBRANOPHONES
Naqareh	MUSICAL_INSTRUMENT.MEMBRANOPHONES
O-daiko	MUSICAL_INSTRUMENT.MEMBRANOPHONES
Okedo-daiko	MUSICAL_INSTRUMENT.MEMBRANOPHONES
Octaban	MUSICAL_INSTRUMENT.MEMBRANOPHONES
Pakhavaj	MUSICAL_INSTRUMENT.MEMBRANOPHONES
Pandero	MUSICAL_INSTRUMENT.MEMBRANOPHONES
Piccolo snare	MUSICAL_INSTRUMENT.MEMBRANOPHONES
Sabar	MUSICAL_INSTRUMENT.MEMBRANOPHONES
Samphor	MUSICAL_INSTRUMENT.MEMBRANOPHONES
Shime-jishi daiko	MUSICAL_INSTRUMENT.MEMBRANOPHONES
Snare	MUSICAL_INSTRUMENT.MEMBRANOPHONES
Surdo	MUSICAL_INSTRUMENT.MEMBRANOPHONES
Tabla	MUSICAL_INSTRUMENT.MEMBRANOPHONES
Taiko	MUSICAL_INSTRUMENT.MEMBRANOPHONES
Talking drum	MUSICAL_INSTRUMENT.MEMBRANOPHONES
Tsukeshime-daiko	MUSICAL_INSTRUMENT.MEMBRANOPHONES
Tsuzumi	MUSICAL_INSTRUMENT.MEMBRANOPHONES
Tambor huacana	MUSICAL_INSTRUMENT.MEMBRANOPHONES
Tamboril	MUSICAL_INSTRUMENT.MEMBRANOPHONES
Tamborita	MUSICAL_INSTRUMENT.MEMBRANOPHONES
Tambou bas a d� fas	MUSICAL_INSTRUMENT.MEMBRANOPHONES
Tambou bas a yon fas	MUSICAL_INSTRUMENT.MEMBRANOPHONES
Tan-tan	MUSICAL_INSTRUMENT.MEMBRANOPHONES
Taphon	MUSICAL_INSTRUMENT.MEMBRANOPHONES
Thavil	MUSICAL_INSTRUMENT.MEMBRANOPHONES
Timpani	MUSICAL_INSTRUMENT.MEMBRANOPHONES
kettledrum	MUSICAL_INSTRUMENT.MEMBRANOPHONES
Tom-tom	MUSICAL_INSTRUMENT.MEMBRANOPHONES
Tombak	MUSICAL_INSTRUMENT.MEMBRANOPHONES
Repique	MUSICAL_INSTRUMENT.MEMBRANOPHONES
Uchiwa-daiko	MUSICAL_INSTRUMENT.MEMBRANOPHONES
Accordola	MUSICAL_INSTRUMENT.WIND
Air horn	MUSICAL_INSTRUMENT.WIND
Alboka	MUSICAL_INSTRUMENT.WIND
Alphorn	MUSICAL_INSTRUMENT.WIND
Alto horn	MUSICAL_INSTRUMENT.WIND
Arghul	MUSICAL_INSTRUMENT.WIND
Atenteben	MUSICAL_INSTRUMENT.WIND
Bagpipe	MUSICAL_INSTRUMENT.WIND
Balaban	MUSICAL_INSTRUMENT.WIND
Bandone�n	MUSICAL_INSTRUMENT.WIND
Bansuri	MUSICAL_INSTRUMENT.WIND
Baritone horn	MUSICAL_INSTRUMENT.WIND
Baritone voice	MUSICAL_INSTRUMENT.WIND
Bassoon	MUSICAL_INSTRUMENT.WIND
Bawu	MUSICAL_INSTRUMENT.WIND
Bayan	MUSICAL_INSTRUMENT.WIND
Bazooka	MUSICAL_INSTRUMENT.WIND
Beatboxing	MUSICAL_INSTRUMENT.WIND
Bifora	MUSICAL_INSTRUMENT.WIND
Blul	MUSICAL_INSTRUMENT.WIND
Bombarde	MUSICAL_INSTRUMENT.WIND
Buccina	MUSICAL_INSTRUMENT.WIND
Bugle	MUSICAL_INSTRUMENT.WIND
Bullroarer	MUSICAL_INSTRUMENT.WIND
Calliope	MUSICAL_INSTRUMENT.WIND
Castrato	MUSICAL_INSTRUMENT.WIND
Chalumeau	MUSICAL_INSTRUMENT.WIND
Cimbasso	MUSICAL_INSTRUMENT.WIND
Clarinets	MUSICAL_INSTRUMENT.WIND
Clarytone	MUSICAL_INSTRUMENT.WIND
Concertina	MUSICAL_INSTRUMENT.WIND
Conch	MUSICAL_INSTRUMENT.WIND
Cornamuse	MUSICAL_INSTRUMENT.WIND
Cornet	MUSICAL_INSTRUMENT.WIND
Cornett	MUSICAL_INSTRUMENT.WIND
Cornu	MUSICAL_INSTRUMENT.WIND
Corrugaphone	MUSICAL_INSTRUMENT.WIND
Countertenor	MUSICAL_INSTRUMENT.WIND
Cromorne	MUSICAL_INSTRUMENT.WIND
Crumhorn	MUSICAL_INSTRUMENT.WIND
Danso	MUSICAL_INSTRUMENT.WIND
Death growl	MUSICAL_INSTRUMENT.WIND
Didgeridoo	MUSICAL_INSTRUMENT.WIND
Diple 	MUSICAL_INSTRUMENT.WIND
dvojnice	MUSICAL_INSTRUMENT.WIND
Dizi	MUSICAL_INSTRUMENT.WIND
Double bell euphonium	MUSICAL_INSTRUMENT.WIND
Doulophone	MUSICAL_INSTRUMENT.WIND
Cuprophone	MUSICAL_INSTRUMENT.WIND
Duduk	MUSICAL_INSTRUMENT.WIND
Dulcian	MUSICAL_INSTRUMENT.WIND
Dulzaina	MUSICAL_INSTRUMENT.WIND
Dung-Dkar	MUSICAL_INSTRUMENT.WIND
Dzhamara	MUSICAL_INSTRUMENT.WIND
English horn	MUSICAL_INSTRUMENT.WIND
Euphonium	MUSICAL_INSTRUMENT.WIND
Falsetto	MUSICAL_INSTRUMENT.WIND
Fife	MUSICAL_INSTRUMENT.WIND
Firebird (trumpet)	MUSICAL_INSTRUMENT.WIND
Fiscorn	MUSICAL_INSTRUMENT.WIND
Flabiol	MUSICAL_INSTRUMENT.WIND
Flageolet	MUSICAL_INSTRUMENT.WIND
Flatt trumpet	MUSICAL_INSTRUMENT.WIND
Flugelhorn	MUSICAL_INSTRUMENT.WIND
Flumpet	MUSICAL_INSTRUMENT.WIND
Flutina	MUSICAL_INSTRUMENT.WIND
Flute	MUSICAL_INSTRUMENT.WIND
Folgerphone	MUSICAL_INSTRUMENT.WIND
French horn	MUSICAL_INSTRUMENT.WIND
Fujara	MUSICAL_INSTRUMENT.WIND
Gaida	MUSICAL_INSTRUMENT.WIND
Garmon	MUSICAL_INSTRUMENT.WIND
Gemshorn	MUSICAL_INSTRUMENT.WIND
Gralla	MUSICAL_INSTRUMENT.WIND
Guan	MUSICAL_INSTRUMENT.WIND
Hano	MUSICAL_INSTRUMENT.WIND
Harmoneon	MUSICAL_INSTRUMENT.WIND
Harmonica	MUSICAL_INSTRUMENT.WIND
Harmonium	MUSICAL_INSTRUMENT.WIND
Heckelphone	MUSICAL_INSTRUMENT.WIND
Helicon	MUSICAL_INSTRUMENT.WIND
Horagai	MUSICAL_INSTRUMENT.WIND
Hosaphone	MUSICAL_INSTRUMENT.WIND
Hotchiku	MUSICAL_INSTRUMENT.WIND
Hulusi	MUSICAL_INSTRUMENT.WIND
Hun	MUSICAL_INSTRUMENT.WIND
Inci	MUSICAL_INSTRUMENT.WIND
Irish flute	MUSICAL_INSTRUMENT.WIND
Jug	MUSICAL_INSTRUMENT.WIND
Kagurabue	MUSICAL_INSTRUMENT.WIND
Kalaleng	MUSICAL_INSTRUMENT.WIND
Kaval	MUSICAL_INSTRUMENT.WIND
Kazoo	MUSICAL_INSTRUMENT.WIND
Key bugle	MUSICAL_INSTRUMENT.WIND
Khene	MUSICAL_INSTRUMENT.WIND
Khloy	MUSICAL_INSTRUMENT.WIND
Khlui	MUSICAL_INSTRUMENT.WIND
Komabue	MUSICAL_INSTRUMENT.WIND
Koncovka	MUSICAL_INSTRUMENT.WIND
Kortholt	MUSICAL_INSTRUMENT.WIND
Koudi	MUSICAL_INSTRUMENT.WIND
Kuhlohorn	MUSICAL_INSTRUMENT.WIND
Launeddas	MUSICAL_INSTRUMENT.WIND
Livenka	MUSICAL_INSTRUMENT.WIND
Lusheng	MUSICAL_INSTRUMENT.WIND
Mangtong	MUSICAL_INSTRUMENT.WIND
Lituus	MUSICAL_INSTRUMENT.WIND
Mellophone	MUSICAL_INSTRUMENT.WIND
Melodica	MUSICAL_INSTRUMENT.WIND
Melodeon	MUSICAL_INSTRUMENT.WIND
Mezzo-soprano	MUSICAL_INSTRUMENT.WIND
Mijwiz	MUSICAL_INSTRUMENT.WIND
Mizmar	MUSICAL_INSTRUMENT.WIND
Musette de cour	MUSICAL_INSTRUMENT.WIND
Nadaswaram	MUSICAL_INSTRUMENT.WIND
Nagak	MUSICAL_INSTRUMENT.WIND
Ncas	MUSICAL_INSTRUMENT.WIND
Ney	MUSICAL_INSTRUMENT.WIND
Nguru	MUSICAL_INSTRUMENT.WIND
Nohkan	MUSICAL_INSTRUMENT.WIND
Nose flute	MUSICAL_INSTRUMENT.WIND
Nplooj	MUSICAL_INSTRUMENT.WIND
Oboe	MUSICAL_INSTRUMENT.WIND
Ocarina	MUSICAL_INSTRUMENT.WIND
Octavin	MUSICAL_INSTRUMENT.WIND
Ophicleide	MUSICAL_INSTRUMENT.WIND
Paixiao	MUSICAL_INSTRUMENT.WIND
Palendag	MUSICAL_INSTRUMENT.WIND
Pan flute	MUSICAL_INSTRUMENT.WIND
Pasiyak	MUSICAL_INSTRUMENT.WIND
water whistle	MUSICAL_INSTRUMENT.WIND
Pavari	MUSICAL_INSTRUMENT.WIND
Pibgorn	MUSICAL_INSTRUMENT.WIND
Picco pipe	MUSICAL_INSTRUMENT.WIND
Piccolo	MUSICAL_INSTRUMENT.WIND
Piccolo trumpet	MUSICAL_INSTRUMENT.WIND
Pipe organ	MUSICAL_INSTRUMENT.WIND
Reed pipes	MUSICAL_INSTRUMENT.WIND
Pitch pipe	MUSICAL_INSTRUMENT.WIND
Pocket cornet	MUSICAL_INSTRUMENT.WIND
Pocket trumpet	MUSICAL_INSTRUMENT.WIND
Post horn	MUSICAL_INSTRUMENT.WIND
Pu	MUSICAL_INSTRUMENT.WIND
Pulalu	MUSICAL_INSTRUMENT.WIND
Qeej	MUSICAL_INSTRUMENT.WIND
Quena	MUSICAL_INSTRUMENT.WIND
Quinticlave	MUSICAL_INSTRUMENT.WIND
Raj	MUSICAL_INSTRUMENT.WIND
Rackett	MUSICAL_INSTRUMENT.WIND
Rapping	MUSICAL_INSTRUMENT.WIND
Rauschpfeife	MUSICAL_INSTRUMENT.WIND
Recorder	MUSICAL_INSTRUMENT.WIND
Reed contrabass	MUSICAL_INSTRUMENT.WIND
Reed organ	MUSICAL_INSTRUMENT.WIND
Rhaita	MUSICAL_INSTRUMENT.WIND
Robero	MUSICAL_INSTRUMENT.WIND
Roman tuba	MUSICAL_INSTRUMENT.WIND
Ryuteki	MUSICAL_INSTRUMENT.WIND
Saenghwang	MUSICAL_INSTRUMENT.WIND
Sackbut	MUSICAL_INSTRUMENT.WIND
Samponia	MUSICAL_INSTRUMENT.WIND
Saratovskaya garmonika	MUSICAL_INSTRUMENT.WIND
Sarrusophones	MUSICAL_INSTRUMENT.WIND
Saxophones	MUSICAL_INSTRUMENT.WIND
Saxhorn	MUSICAL_INSTRUMENT.WIND
Saxotromba	MUSICAL_INSTRUMENT.WIND
Saxtuba	MUSICAL_INSTRUMENT.WIND
Scat singing	MUSICAL_INSTRUMENT.WIND
Schwyzer�rgeli	MUSICAL_INSTRUMENT.WIND
Serpent	MUSICAL_INSTRUMENT.WIND
Shakuhachi	MUSICAL_INSTRUMENT.WIND
Shankha	MUSICAL_INSTRUMENT.WIND
Shawm	MUSICAL_INSTRUMENT.WIND
Shehnai	MUSICAL_INSTRUMENT.WIND
Sheng	MUSICAL_INSTRUMENT.WIND
Shinobue	MUSICAL_INSTRUMENT.WIND
Shofar	MUSICAL_INSTRUMENT.WIND
Shvi	MUSICAL_INSTRUMENT.WIND
Siku	MUSICAL_INSTRUMENT.WIND
Siren	MUSICAL_INSTRUMENT.WIND
Slide trumpet	MUSICAL_INSTRUMENT.WIND
Slide whistle	MUSICAL_INSTRUMENT.WIND
Sodina	MUSICAL_INSTRUMENT.WIND
Sopila	MUSICAL_INSTRUMENT.WIND
Soprano	MUSICAL_INSTRUMENT.WIND
Sorna	MUSICAL_INSTRUMENT.WIND
Sousaphone	MUSICAL_INSTRUMENT.WIND
Sralai	MUSICAL_INSTRUMENT.WIND
Sudrophone	MUSICAL_INSTRUMENT.WIND
Suling	MUSICAL_INSTRUMENT.WIND
Suona	MUSICAL_INSTRUMENT.WIND
Superbone	MUSICAL_INSTRUMENT.WIND
Swordblade	MUSICAL_INSTRUMENT.WIND
Tabor pipe	MUSICAL_INSTRUMENT.WIND
Taepyeongso	MUSICAL_INSTRUMENT.WIND
Tarogato	MUSICAL_INSTRUMENT.WIND
Tenor	MUSICAL_INSTRUMENT.WIND
Tenora	MUSICAL_INSTRUMENT.WIND
Throat singing	MUSICAL_INSTRUMENT.WIND
Tible	MUSICAL_INSTRUMENT.WIND
Tin whistle	MUSICAL_INSTRUMENT.WIND
Toasting	MUSICAL_INSTRUMENT.WIND
Tonette	MUSICAL_INSTRUMENT.WIND
Trikiti	MUSICAL_INSTRUMENT.WIND
Trombones	MUSICAL_INSTRUMENT.WIND
Tromboon	MUSICAL_INSTRUMENT.WIND
Trompeta china	MUSICAL_INSTRUMENT.WIND
Trumpets	MUSICAL_INSTRUMENT.WIND
Tuba	MUSICAL_INSTRUMENT.WIND
Tube trumpet	MUSICAL_INSTRUMENT.WIND
Tumpong	MUSICAL_INSTRUMENT.WIND
Tungso	MUSICAL_INSTRUMENT.WIND
Tutek	MUSICAL_INSTRUMENT.WIND
Txistu	MUSICAL_INSTRUMENT.WIND
Uilleann pipes	MUSICAL_INSTRUMENT.WIND
Venu	MUSICAL_INSTRUMENT.WIND
Vibrandoneon	MUSICAL_INSTRUMENT.WIND
Vienna horn	MUSICAL_INSTRUMENT.WIND
Vocal percussion	MUSICAL_INSTRUMENT.WIND
Vuvuzela	MUSICAL_INSTRUMENT.WIND
Wagner tuba	MUSICAL_INSTRUMENT.WIND
Washint	MUSICAL_INSTRUMENT.WIND
Western concert flutes	MUSICAL_INSTRUMENT.WIND
Whip	MUSICAL_INSTRUMENT.WIND
Whistle	MUSICAL_INSTRUMENT.WIND
Willow flute	MUSICAL_INSTRUMENT.WIND
Xiao	MUSICAL_INSTRUMENT.WIND
Xun	MUSICAL_INSTRUMENT.WIND
Yodel	MUSICAL_INSTRUMENT.WIND
Yotar	MUSICAL_INSTRUMENT.WIND
Yu	MUSICAL_INSTRUMENT.WIND
Zhaleika	MUSICAL_INSTRUMENT.WIND
Zufolo	MUSICAL_INSTRUMENT.WIND
Zugtrompette	MUSICAL_INSTRUMENT.WIND
Zurna	MUSICAL_INSTRUMENT.WIND
Aeolian harp	MUSICAL_INSTRUMENT.STRING
Ajaeng	MUSICAL_INSTRUMENT.STRING
Appalachian dulcimer	MUSICAL_INSTRUMENT.STRING
Archlute	MUSICAL_INSTRUMENT.STRING
Arpeggione	MUSICAL_INSTRUMENT.STRING
Autoharp	MUSICAL_INSTRUMENT.STRING
Baglama	MUSICAL_INSTRUMENT.STRING
Balalaika	MUSICAL_INSTRUMENT.STRING
Bandol�n	MUSICAL_INSTRUMENT.STRING
Bandura	MUSICAL_INSTRUMENT.STRING
Bandurria	MUSICAL_INSTRUMENT.STRING
Banjo	MUSICAL_INSTRUMENT.STRING
Banjo mandolin	MUSICAL_INSTRUMENT.STRING
Banjo ukulele	MUSICAL_INSTRUMENT.STRING
Barbat	MUSICAL_INSTRUMENT.STRING
Baryton	MUSICAL_INSTRUMENT.STRING
Berimbau	MUSICAL_INSTRUMENT.STRING
Biwa	MUSICAL_INSTRUMENT.STRING
Bordonua	MUSICAL_INSTRUMENT.STRING
Bouzouki	MUSICAL_INSTRUMENT.STRING
Cavaquinho	MUSICAL_INSTRUMENT.STRING
Clavinet	MUSICAL_INSTRUMENT.STRING
Chapman stick	MUSICAL_INSTRUMENT.STRING
Charangos	MUSICAL_INSTRUMENT.STRING
Cimbalom	MUSICAL_INSTRUMENT.STRING
Cuatro	MUSICAL_INSTRUMENT.STRING
Citole	MUSICAL_INSTRUMENT.STRING
Cittern	MUSICAL_INSTRUMENT.STRING
Clavichord	MUSICAL_INSTRUMENT.STRING
Crwth	MUSICAL_INSTRUMENT.STRING
Cuatro	MUSICAL_INSTRUMENT.STRING
Dahu	MUSICAL_INSTRUMENT.STRING
Diddley bow	MUSICAL_INSTRUMENT.STRING
Dihu	MUSICAL_INSTRUMENT.STRING
Dombra	MUSICAL_INSTRUMENT.STRING
Domra	MUSICAL_INSTRUMENT.STRING
Double-neck guitjo	MUSICAL_INSTRUMENT.STRING
Double bass	MUSICAL_INSTRUMENT.STRING
Dutar	MUSICAL_INSTRUMENT.STRING
Duxianqin	MUSICAL_INSTRUMENT.STRING
Ektara	MUSICAL_INSTRUMENT.STRING
Erhu	MUSICAL_INSTRUMENT.STRING
Erxian	MUSICAL_INSTRUMENT.STRING
Esraj	MUSICAL_INSTRUMENT.STRING
Faglong/Fuglung	MUSICAL_INSTRUMENT.STRING
Fegereng	MUSICAL_INSTRUMENT.STRING
Fiddle	MUSICAL_INSTRUMENT.STRING
Gayageum	MUSICAL_INSTRUMENT.STRING
Gehu	MUSICAL_INSTRUMENT.STRING
Geomungo	MUSICAL_INSTRUMENT.STRING
Gittern	MUSICAL_INSTRUMENT.STRING
Gopuz	MUSICAL_INSTRUMENT.STRING
Gottuvadhyam	MUSICAL_INSTRUMENT.STRING
Guitar	MUSICAL_INSTRUMENT.STRING
Baritone Guitar	MUSICAL_INSTRUMENT.STRING
Bass guitar	MUSICAL_INSTRUMENT.STRING
Chitarra battente	MUSICAL_INSTRUMENT.STRING
Cigar box guitar	MUSICAL_INSTRUMENT.STRING
Classical guitar	MUSICAL_INSTRUMENT.STRING
Electric guitar	MUSICAL_INSTRUMENT.STRING
Electric Bass Guitar	MUSICAL_INSTRUMENT.STRING
Extended Range Guitar	MUSICAL_INSTRUMENT.STRING
Flamenco guitar	MUSICAL_INSTRUMENT.STRING
Fusetar	MUSICAL_INSTRUMENT.STRING
Guitarra quinta huapanguera	MUSICAL_INSTRUMENT.STRING
Guitar synthesizer	MUSICAL_INSTRUMENT.STRING
Guitarr�n	MUSICAL_INSTRUMENT.STRING
Guitarr�n	MUSICAL_INSTRUMENT.STRING
Gut-stringed Guitar	MUSICAL_INSTRUMENT.STRING
Lap Steel Guitar	MUSICAL_INSTRUMENT.STRING
Multi-necked Guitar	MUSICAL_INSTRUMENT.STRING
Nine-string Guitar	MUSICAL_INSTRUMENT.STRING
Nylon-stringed Guitar	MUSICAL_INSTRUMENT.STRING
Octave Guitar	MUSICAL_INSTRUMENT.STRING
Resophonic Guitar	MUSICAL_INSTRUMENT.STRING
Steel-Stringed Guitar	MUSICAL_INSTRUMENT.STRING
Tenor Guitar	MUSICAL_INSTRUMENT.STRING
Terz Guitar	MUSICAL_INSTRUMENT.STRING
Twelve-string Guitar	MUSICAL_INSTRUMENT.STRING
Yotar	MUSICAL_INSTRUMENT.STRING
Gusli	MUSICAL_INSTRUMENT.STRING
Guqin	MUSICAL_INSTRUMENT.STRING
Guzheng	MUSICAL_INSTRUMENT.STRING
Haegeum	MUSICAL_INSTRUMENT.STRING
Hammered Dulcimer	MUSICAL_INSTRUMENT.STRING
Hardanger fiddle	MUSICAL_INSTRUMENT.STRING
Harmonico	MUSICAL_INSTRUMENT.STRING
Harp	MUSICAL_INSTRUMENT.STRING
Harpsichord	MUSICAL_INSTRUMENT.STRING
Hegelong	MUSICAL_INSTRUMENT.STRING
Huluhu	MUSICAL_INSTRUMENT.STRING
Huqin	MUSICAL_INSTRUMENT.STRING
Hurdy-gurdy	MUSICAL_INSTRUMENT.STRING
Igil	MUSICAL_INSTRUMENT.STRING
Irish bouzouki	MUSICAL_INSTRUMENT.STRING
Jarana de son jarocho	MUSICAL_INSTRUMENT.STRING
Jarana huasteca	MUSICAL_INSTRUMENT.STRING
Jarana mosquito	MUSICAL_INSTRUMENT.STRING
Jarana segunda	MUSICAL_INSTRUMENT.STRING
Jarana tercera	MUSICAL_INSTRUMENT.STRING
Jiaohu	MUSICAL_INSTRUMENT.STRING
Kabosy	MUSICAL_INSTRUMENT.STRING
Kadlong	MUSICAL_INSTRUMENT.STRING
Kamancha	MUSICAL_INSTRUMENT.STRING
Kantele	MUSICAL_INSTRUMENT.STRING
Kemenche	MUSICAL_INSTRUMENT.STRING
Khim	MUSICAL_INSTRUMENT.STRING
Kobza	MUSICAL_INSTRUMENT.STRING
Kokles	MUSICAL_INSTRUMENT.STRING
Komungo	MUSICAL_INSTRUMENT.STRING
Kora	MUSICAL_INSTRUMENT.STRING
Koto	MUSICAL_INSTRUMENT.STRING
Kubing	MUSICAL_INSTRUMENT.STRING
Kudyapi	MUSICAL_INSTRUMENT.STRING
Langeleik	MUSICAL_INSTRUMENT.STRING
Laruan	MUSICAL_INSTRUMENT.STRING
Leiqin	MUSICAL_INSTRUMENT.STRING
Lirone	MUSICAL_INSTRUMENT.STRING
Lokanga	MUSICAL_INSTRUMENT.STRING
Lute	MUSICAL_INSTRUMENT.STRING
Lyre	MUSICAL_INSTRUMENT.STRING
Maguhu	MUSICAL_INSTRUMENT.STRING
Mandola	MUSICAL_INSTRUMENT.STRING
Mando-bass	MUSICAL_INSTRUMENT.STRING
Mandocello	MUSICAL_INSTRUMENT.STRING
Mandolin	MUSICAL_INSTRUMENT.STRING
Mandora	MUSICAL_INSTRUMENT.STRING
Mandore	MUSICAL_INSTRUMENT.STRING
Marovany	MUSICAL_INSTRUMENT.STRING
Mohan veena	MUSICAL_INSTRUMENT.STRING
Morin khuur	MUSICAL_INSTRUMENT.STRING
Musical bow	MUSICAL_INSTRUMENT.STRING
Nyckelharpa	MUSICAL_INSTRUMENT.STRING
Octobass	MUSICAL_INSTRUMENT.STRING
Oud	MUSICAL_INSTRUMENT.STRING
Piano	MUSICAL_INSTRUMENT.STRING
Pipa	MUSICAL_INSTRUMENT.STRING
Piwancha	MUSICAL_INSTRUMENT.STRING
Portuguese guitar	MUSICAL_INSTRUMENT.STRING
Psaltery	MUSICAL_INSTRUMENT.STRING
Ravanahatha	MUSICAL_INSTRUMENT.STRING
Rebab	MUSICAL_INSTRUMENT.STRING
Rebec	MUSICAL_INSTRUMENT.STRING
Requinto jarocho	MUSICAL_INSTRUMENT.STRING
Ruan	MUSICAL_INSTRUMENT.STRING
Rudra vina	MUSICAL_INSTRUMENT.STRING
Sallameh	MUSICAL_INSTRUMENT.STRING
Sanshin	MUSICAL_INSTRUMENT.STRING
Santoor	MUSICAL_INSTRUMENT.STRING
Sanxian	MUSICAL_INSTRUMENT.STRING
Sarangi	MUSICAL_INSTRUMENT.STRING
Sarod	MUSICAL_INSTRUMENT.STRING
Saung	MUSICAL_INSTRUMENT.STRING
Saw sam sai	MUSICAL_INSTRUMENT.STRING
Saz	MUSICAL_INSTRUMENT.STRING
Se	MUSICAL_INSTRUMENT.STRING
Shamisen	MUSICAL_INSTRUMENT.STRING
Setar	MUSICAL_INSTRUMENT.STRING
Sitar	MUSICAL_INSTRUMENT.STRING
Sitarla	MUSICAL_INSTRUMENT.STRING
Stroh violin	MUSICAL_INSTRUMENT.STRING
Sopranino mandolin	MUSICAL_INSTRUMENT.STRING
Tamburitza	MUSICAL_INSTRUMENT.STRING
Tanpura	MUSICAL_INSTRUMENT.STRING
lute	MUSICAL_INSTRUMENT.STRING
Tea chest bass	MUSICAL_INSTRUMENT.STRING
Temb�r	MUSICAL_INSTRUMENT.STRING
Theorbo	MUSICAL_INSTRUMENT.STRING
Timple	MUSICAL_INSTRUMENT.STRING
Tres	MUSICAL_INSTRUMENT.STRING
Tro	MUSICAL_INSTRUMENT.STRING
Trumpet marine	MUSICAL_INSTRUMENT.STRING
tromba marina	MUSICAL_INSTRUMENT.STRING
Tsymbaly	MUSICAL_INSTRUMENT.STRING
Tuhu	MUSICAL_INSTRUMENT.STRING
Ukulele	MUSICAL_INSTRUMENT.STRING
Valiha	MUSICAL_INSTRUMENT.STRING
Veena	MUSICAL_INSTRUMENT.STRING
Vertical viola	MUSICAL_INSTRUMENT.STRING
Vichitra vina	MUSICAL_INSTRUMENT.STRING
Vielle	MUSICAL_INSTRUMENT.STRING
Vihuela	MUSICAL_INSTRUMENT.STRING
Vihuela	MUSICAL_INSTRUMENT.STRING
Viol	MUSICAL_INSTRUMENT.STRING
Viola	MUSICAL_INSTRUMENT.STRING
Viola da gamba	MUSICAL_INSTRUMENT.STRING
Viola de Arame	MUSICAL_INSTRUMENT.STRING
Viola organista	MUSICAL_INSTRUMENT.STRING
Viola da Terra	MUSICAL_INSTRUMENT.STRING
Viola da Terceira	MUSICAL_INSTRUMENT.STRING
Violin	MUSICAL_INSTRUMENT.STRING
Violotta	MUSICAL_INSTRUMENT.STRING
Washtub bass	MUSICAL_INSTRUMENT.STRING
Whamola	MUSICAL_INSTRUMENT.STRING
Wheelharp	MUSICAL_INSTRUMENT.STRING
Xalam/Khalam	MUSICAL_INSTRUMENT.STRING
Xenorphica	MUSICAL_INSTRUMENT.STRING
tanbur	MUSICAL_INSTRUMENT.STRING
Yazheng	MUSICAL_INSTRUMENT.STRING
Yangqin	MUSICAL_INSTRUMENT.STRING
Zhonghu	MUSICAL_INSTRUMENT.STRING
Zhuihu	MUSICAL_INSTRUMENT.STRING
Zither	MUSICAL_INSTRUMENT.STRING
