Asia	CONTINENT
Africa	CONTINENT
Austrailia	CONTINENT
Antarctica	CONTINENT
Europe	CONTINENT
North America	CONTINENT
South America	CONTINENT
Oceania	CONTINENT
Afghanistan	COUNTRY
Albania	COUNTRY
Algeria	COUNTRY
Andorra	COUNTRY
Angola	COUNTRY
Antigua	COUNTRY
Antigua & Deps	COUNTRY
Antigua & Dependencies	COUNTRY
Antigua and Deps	COUNTRY
Antigua and Dependencies	COUNTRY
Argentina	COUNTRY
Armenia	COUNTRY
Australia	COUNTRY
Austria	COUNTRY
Azerbaijan	COUNTRY
Bahamas	COUNTRY
Bahrain	COUNTRY
Bangladesh	COUNTRY
Barbados	COUNTRY
Belarus	COUNTRY
Belgium	COUNTRY
Belize	COUNTRY
Benin	COUNTRY
Bhutan	COUNTRY
Bolivia	COUNTRY
Bosnia	COUNTRY
Bosnia Herzegovina	COUNTRY
Herzegovina	COUNTRY
Bosnia and Herzegovina	COUNTRY
Bosnia & Herzegovina	COUNTRY
Botswana	COUNTRY
Brazil	COUNTRY
Brunei	COUNTRY
Bulgaria	COUNTRY
Burkina	COUNTRY
Burundi	COUNTRY
Cambodia	COUNTRY
Cameroon	COUNTRY
Canada	COUNTRY
Cape Verde	COUNTRY
Central African Rep	COUNTRY
Central African Republic	COUNTRY
Chad	COUNTRY
Chile	COUNTRY
China	COUNTRY
Colombia	COUNTRY
Comoros	COUNTRY
Congo	COUNTRY
Democratic Republic of Congo	COUNTRY
Costa Rica	COUNTRY
Croatia	COUNTRY
Cuba	COUNTRY
Cyprus	COUNTRY
Republic of Cyprus	COUNTRY
Turkish Republic of Northern Cyprus	COUNTRY
Northern Cyprus?	COUNTRY
Turkish Republic of Cyprus	COUNTRY
Czech Republic	COUNTRY
Czechia?	COUNTRY
Denmark?	COUNTRY
Djibouti	COUNTRY
Dominica	COUNTRY
Dominican Republic	COUNTRY
East Timor	COUNTRY
Ecuador	COUNTRY
Egypt	COUNTRY
El Salvador	COUNTRY
Equatorial Guinea	COUNTRY
Eritrea	COUNTRY
Estonia	COUNTRY
Ethiopia	COUNTRY
Fiji	COUNTRY
Finland	COUNTRY
France	COUNTRY
Gabon	COUNTRY
Gambia	COUNTRY
Georgia	COUNTRY
Germany	COUNTRY
Ghana	COUNTRY
Greece	COUNTRY
Grenada	COUNTRY
Guatemala	COUNTRY
Guinea	COUNTRY
Guinea-Bissau	COUNTRY
Guyana	COUNTRY
Haiti	COUNTRY
Honduras	COUNTRY
Hungary	COUNTRY
Iceland	COUNTRY
India	COUNTRY
Indonesia	COUNTRY
Iran	COUNTRY
Iraq	COUNTRY
Republic of Ireland	COUNTRY
Ireland	COUNTRY
Republic of Ireland	COUNTRY
South Ireland	COUNTRY
Northern Ireland	COUNTRY
Southern Ireland	COUNTRY
North Ireland	COUNTRY
Israel	COUNTRY
Italy	COUNTRY
Ivory Coast	COUNTRY
Jamaica	COUNTRY
Japan	COUNTRY
Jordan	COUNTRY
Kazakhstan	COUNTRY
Kenya	COUNTRY
Kiribati	COUNTRY
North Korea	COUNTRY
South Korea	COUNTRY
Democratic People's Republic of Korea	COUNTRY
Republic of Korea	COUNTRY
Korea	COUNTRY
Kosovo	COUNTRY
Kuwait	COUNTRY
Kyrgyzstan	COUNTRY
Laos	COUNTRY
Latvia	COUNTRY
Lebanon	COUNTRY
Lesotho	COUNTRY
Liberia	COUNTRY
Libya	COUNTRY
Liechtenstein	COUNTRY
Lithuania	COUNTRY
Luxembourg	COUNTRY
Macedonia	COUNTRY
Madagascar	COUNTRY
Malawi	COUNTRY
Malaysia	COUNTRY
Maldives	COUNTRY
Mali	COUNTRY
Malta	COUNTRY
Marshall Islands	COUNTRY
Mauritania	COUNTRY
Mauritius	COUNTRY
Mexico	COUNTRY
Micronesia	COUNTRY
Moldova	COUNTRY
Monaco	COUNTRY
Mongolia	COUNTRY
Montenegro	COUNTRY
Morocco	COUNTRY
Mozambique	COUNTRY
Myanmar	COUNTRY
Namibia	COUNTRY
Nauru	COUNTRY
Nepal	COUNTRY
Netherlands	COUNTRY
New Zealand	COUNTRY
Nicaragua	COUNTRY
Niger	COUNTRY
Nigeria	COUNTRY
Norway	COUNTRY
Oman	COUNTRY
Pakistan	COUNTRY
Palau	COUNTRY
Panama	COUNTRY
Papua New Guinea	COUNTRY
Paraguay	COUNTRY
Peru	COUNTRY
Philippines	COUNTRY
Poland	COUNTRY
Portugal	COUNTRY
Qatar	COUNTRY
Romania	COUNTRY
Russia	COUNTRY
Russian Federation	COUNTRY
Rwanda	COUNTRY
St Kitts & Nevis	COUNTRY
St Lucia	COUNTRY
Saint Vincent & the Grenadines	COUNTRY
Samoa	COUNTRY
San Marino	COUNTRY
Sao Tome & Principe	COUNTRY
Sao Tome and Principe	COUNTRY
Saudi Arabia	COUNTRY
Senegal	COUNTRY
Serbia	COUNTRY
Seychelles	COUNTRY
Sierra Leone	COUNTRY
Singapore	COUNTRY
Slovakia	COUNTRY
Slovenia	COUNTRY
Solomon Islands	COUNTRY
Somalia	COUNTRY
Puntland	COUNTRY
Somaliland	COUNTRY
South Africa	COUNTRY
South Sudan	COUNTRY
Spain	COUNTRY
Sri Lanka	COUNTRY
Sudan	COUNTRY
Suriname	COUNTRY
Swaziland	COUNTRY
Sweden	COUNTRY
Switzerland	COUNTRY
Syria	COUNTRY
Taiwan	COUNTRY
Tajikistan	COUNTRY
Tanzania	COUNTRY
Thailand	COUNTRY
Togo	COUNTRY
Tonga	COUNTRY
Trinidad & Tobago	COUNTRY
Tunisia	COUNTRY
Turkey	COUNTRY
Turkmenistan	COUNTRY
Tuvalu	COUNTRY
Uganda	COUNTRY
Ukraine	COUNTRY
United Arab Emirates	COUNTRY
United Kingdom	COUNTRY
United States	COUNTRY
Uruguay	COUNTRY
Uzbekistan	COUNTRY
Vanuatu	COUNTRY
Vatican City	COUNTRY
Venezuela	COUNTRY
Vietnam	COUNTRY
Yemen	COUNTRY
Zambia	COUNTRY
Zimbabwe	COUNTRY
Republic of China	COUNTRY
People's Republic of China	COUNTRY
Alabama	STATE
Alaska	STATE
Arizona	STATE
Arkansas	STATE
California	STATE
Colorado	STATE
Connecticut	STATE
Delaware	STATE
Florida	STATE
Georgia	STATE
Hawaii	STATE
Idaho	STATE
Illinois	STATE
Indiana	STATE
Iowa	STATE
Kansas	STATE
Kentucky	STATE
Louisiana	STATE
Maine	STATE
Maryland	STATE
Massachusetts	STATE
Michigan	STATE
Minnesota	STATE
Mississippi	STATE
Missouri	STATE
Montana	STATE
Nebraska	STATE
Nevada	STATE
New Hampshire	STATE
New Jersey	STATE
New Mexico	STATE
New York	STATE
North Carolina	STATE
North Dakota	STATE
Ohio	STATE
Oklahoma	STATE
Oregon	STATE
Pennsylvania	STATE
Rhode Island	STATE
South Carolina	STATE
South Dakota	STATE
Tennessee	STATE
Texas	STATE
Utah	STATE
Vermont	STATE
Virginia	STATE
Washington	STATE
West Virginia	STATE
Wisconsin	STATE
Wyoming	STATE
SHANGHAI	CITY.CHINA
BEIJING	CITY.CHINA
ISTANBUL	CITY.TURKEY
MUMBAI	CITY.INDIA
KARACHI	CITY.PAKISTAN
MOSKVA	CITY.RUSSIA
SÃO PAULO	CITY.BRAZIL
SAO PAULO	CITY.BRAZIL
TIANJIN	CITY.CHINA
GUANGZHOU	CITY.CHINA
DELHI	CITY.INDIA
LAGOS	CITY.NIGERIA
SHENZHEN	CITY.CHINA
SEOUL	CITY.REPUBLIC OF KOREA
WUHAN	CITY.CHINA
JAKARTA	CITY.INDONESIA
LIMA	CITY.PERU
MEXICO CITY	CITY.MEXICO
TOKYO	CITY.JAPAN
BENGALURU	CITY.INDIA
NEW YORK	CITY.USA
BANGKOK	CITY.THAILAND
DONGGUAN	CITY.CHINA
LONDON	CITY.UNITED KINGDOM
TEHERAN	CITY.IRAN
CAIRO	CITY.EGYPT
CHENGDU	CITY.CHINA
BOGOTÁ	CITY.COLOMBIA
BOGOTA	CITY.COLOMBIA
CHONGQING	CITY.CHINA
KINSHASA	CITY.DEMOCRATIC REPUBLIC OF THE CONGO
AHMEDABAD	CITY.INDIA
NANJING	CITY.CHINA
HỒ CHÍ MINH STADT	CITY.VIETNAM
HO CHI MINH	CITY.VIETNAM
HONG KONG	CITY.CHINA
HYDERABAD	CITY.INDIA
XI'AN	CITY.CHINA
LAHORE	CITY.PAKISTAN
RIO DE JANEIRO	CITY.BRAZIL
HÀ NỘI	CITY.VIETNAM
HA NOI	CITY.VIETNAM
ONITSHA	CITY.NIGERIA
SHENYANG	CITY.CHINA
HANGZHOU	CITY.CHINA
BAGDAD	CITY.IRAQ
DHAKA	CITY.BANGLADESH
SINGAPORE	CITY.SINGAPORE
SUZHOU	CITY.CHINA
CARACAS	CITY.VENEZUELA
LUANDA	CITY.ANGOLA
TORONTO	CITY.CANADA
SANTIAGO DE CHILE	CITY.CHILE
ST. PETERSBURG	CITY.RUSSIA
RANGOON	CITY.MYANMAR
CHENNAI	CITY.INDIA
GREATER SYDNEY	CITY.AUSTRALIA
QINGDAO	CITY.CHINA
HARBIN	CITY.CHINA
KHARTUM	CITY.SUDAN
KOLKATA	CITY.INDIA
ALEPPO	CITY.SYRIA
NAIROBI	CITY.KENYA
ANKARA	CITY.TURKEY
JINAN	CITY.CHINA
SYDNEY	CITY.AUSTRALIA
ZHENGZHOU	CITY.CHINA
GREATER MELBOURNE	CITY.AUSTRALIA
ALEXANDRIA	CITY.EGYPT
DALIAN	CITY.CHINA
RIAD	CITY.SAUDI-ARABIA
MELBOURNE	CITY.AUSTRALIA
NEW TAIPEI	CITY.TAIWAN
ABIDJAN	CITY.CÔTE D'IVOIRE
LOS ANGELES	CITY.USA
PUNE	CITY.INDIA
YOKOHAMA	CITY.JAPAN
ACCRA	CITY.GHANA
KUNMING	CITY.CHINA
BUSAN	CITY.REPUBLIC OF KOREA
WUXI	CITY.CHINA
XIAMEN	CITY.CHINA
CHANGCHUN	CITY.CHINA
NINGBO	CITY.CHINA
NANNING	CITY.CHINA
TAIYUAN	CITY.CHINA
BERLIN	CITY.GERMANY
MONTREAL	CITY.CANADA
İZMIR	CITY.TURKEY
HEFEI	CITY.CHINA
CHANGZHOU	CITY.CHINA
KABUL	CITY.AFGHANISTAN
GIZA	CITY.EGYPT
PYONGYANG	CITY.DEMOCRATIC PEOPLE'S REPUBLIC OF KOREA
MADRID	CITY.SPAIN
TANGSHAN	CITY.CHINA
KANO	CITY.NIGERIA
CASABLANCA	CITY.MOROCCO
CHANGSHA	CITY.CHINA
JAIPUR	CITY.INDIA
DAR ES SALAAM	CITY.TANZANIA
XUZHOU	CITY.CHINA
WENZHOU	CITY.CHINA
GUIYANG	CITY.CHINA
ÜRÜMQI	CITY.CHINA
URUMQI	CITY.CHINA
ZIBO	CITY.CHINA
ĀDDĪS ĀBEBĀ	CITY.ETHIOPIA
ADDIS ABEBA	CITY.ETHIOPIA
FUZHOU	CITY.CHINA
SALVADOR	CITY.BRAZIL
BUENOS AIRES	CITY.ARGENTINA
SURAT	CITY.INDIA
SHIJIAZHUANG	CITY.CHINA
BRASÍLIA	CITY.BRAZIL
BRASILIA	CITY.BRAZIL
LUCKNOW	CITY.INDIA
INCHEON	CITY.REPUBLIC OF KOREA
KIEV	CITY.UKRAINE
DSCHIDDA	CITY.SAUDI-ARABIA
KAOHSIUNG	CITY.TAIWAN
ROME	CITY.ITALY
KANPUR	CITY.INDIA
MASHHAD	CITY.IRAN
SURABAYA	CITY.INDONESIA
QUEZON CITY	CITY.PHILIPPINES
TAICHUNG	CITY.TAIWAN
CHICAGO	CITY.USA
TAIPEI	CITY.TAIWAN
OSAKA	CITY.JAPAN
HUAI'AN	CITY.CHINA
LINYI	CITY.CHINA
FAISALABAD	CITY.PAKISTAN
BANDUNG	CITY.INDONESIA
FORTALEZA	CITY.BRAZIL
DAKAR	CITY.SENEGAL
DAMASUS RURAL	CITY.SYRIA
BEKASI	CITY.INDONESIA
DAEGU	CITY.REPUBLIC OF KOREA
LANZHOU	CITY.CHINA
BELO HORIZONTE	CITY.BRAZIL
IBADAN	CITY.NIGERIA
MARACAIBO	CITY.VENEZUELA
ASUNCION	CITY.PARAGUAY
MEDELLÍN	CITY.COLOMBIA
MEDELLIN	CITY.COLOMBIA
NAGPUR	CITY.INDIA
YANGZHOU	CITY.CHINA
ALGIERS	CITY.ALGERIA
NANCHANG	CITY.CHINA
HUIZHOU	CITY.CHINA
CALI	CITY.COLOMBIA
VALENCIA	CITY.VENEZUELA
GUAYAQUIL	CITY.ECUADOR
NYANZA CONURBATION	CITY.KENYA
NANTONG	CITY.CHINA
BASSORAH	CITY.IRAQ
BAMAKO	CITY.MALI
KUMASI	CITY.GHANA
PARIS	CITY.FRANCE
NAGOYA	CITY.JAPAN
MOSSOUL	CITY.IRAQ
XIANGYANG	CITY.CHINA
CHITTAGONG	CITY.BANGLADESH
HOUSTON	CITY.USA
GREATER BRISBANE	CITY.AUSTRALIA
TASHKENT	CITY.UZBEKISTAN
BAKU	CITY.AZERBAIJAN
VANCOUVER	CITY.CANADA
ZAOZHUANG	CITY.CHINA
LA HABANA	CITY.CUBA
BRISBANE	CITY.AUSTRALIA
BAOTOU	CITY.CHINA
TAOYUAN	CITY.TAIWAN
HAIKOU	CITY.CHINA
YIWU	CITY.CHINA
MEDAN	CITY.INDONESIA
AMMAN	CITY.JORDAN
SANA'A	CITY.YEMEN
MANAUS	CITY.BRAZIL
HOHHOT	CITY.CHINA
JILIN CITY	CITY.CHINA
INDORE	CITY.INDIA
PUTIAN	CITY.CHINA
LUOYANG	CITY.CHINA
DOUALA	CITY.CAMEROON
OUAGADOUGOU	CITY.BURKINA FASO
BURSA	CITY.TURKEY
SAPPORO	CITY.JAPAN
TAIZHOU	CITY.CHINA
GREATER PERTH	CITY.AUSTRALIA
MINSK	CITY.BELARUS
TAINAN	CITY.TAIWAN
UYO	CITY.NIGERIA
YANTAI	CITY.CHINA
CURITIBA	CITY.BRAZIL
NANCHONG	CITY.CHINA
HẢI PHÒNG	CITY.VIETNAM
PERTH	CITY.AUSTRALIA
JIANGMEN	CITY.CHINA
THANE	CITY.INDIA
NANYANG	CITY.CHINA
TANGERANG	CITY.INDONESIA
BHOPAL	CITY.INDIA
RAWALPINDI	CITY.PAKISTAN
LU'AN	CITY.CHINA
FUYANG	CITY.CHINA
ESFAHAN	CITY.IRAN
DEPOK	CITY.INDONESIA
LUSAKA	CITY.ZAMBIA
HAMBURG	CITY.GERMANY
BUDAPEST	CITY.HUNGARY
DATONG	CITY.CHINA
TAI'AN	CITY.CHINA
KAMPALA	CITY.UGANDA
VIENNA	CITY.AUSTRIA
VISAKHAPATNAM	CITY.INDIA
WARSAW	CITY.POLAND
PATNA	CITY.INDIA
DAMASCUS	CITY.SYRIA
BUCHAREST	CITY.ROMANIA
HOMS	CITY.SYRIA
HUAINAN	CITY.CHINA
VADODARA	CITY.INDIA
BEOGRADE	CITY.SERBIA
ECATEPEC	CITY.MEXICO
MANILA	CITY.PHILIPPINES
DAQING	CITY.CHINA
SUZHOU	CITY.CHINA
FIROZABAD	CITY.INDIA
KUALA LUMPUR	CITY.MALAYSIA
MANDALAY	CITY.MYANMAR
QUITO	CITY.ECUADOR
SANTA CRUZ	CITY.BOLIVIA
YANCHENG	CITY.CHINA
KARAJ	CITY.IRAN
LUDHIANA	CITY.INDIA
ZHANJIANG	CITY.CHINA
RECIFE	CITY.BRAZIL
HARARE	CITY.ZIMBABWE
RAJKOT	CITY.INDIA
BARCELONA	CITY.SPAIN
TENGZHOU	CITY.CHINA
YAOUNDÉ	CITY.CAMEROON
JIANGYIN	CITY.CHINA
ADANA	CITY.TURKEY
AGRA	CITY.INDIA
SILIGURI	CITY.INDIA
PHNOM PENH	CITY.CAMBODIA
ZHUHAI	CITY.CHINA
SEMARANG	CITY.INDONESIA
PHILADELPHIA	CITY.USA
ANSHAN	CITY.CHINA
KOBE	CITY.JAPAN
AUCKLAND	CITY.NEW ZEALAND
WEIFANG	CITY.CHINA
DAEJEON	CITY.REPUBLIC OF KOREA
PHOENIX	CITY.USA
NOVOSIBIRSK	CITY.RUSSIA
CHANGSHU	CITY.CHINA
HAMA	CITY.SYRIA
BRAZZAVILLE	CITY.REPUBLIC OF THE CONGO
GUADALAJARA	CITY.MEXICO
TABRIZ	CITY.IRAN
GUIGANG	CITY.CHINA
CALOOCAN	CITY.PHILIPPINES
NASHIK	CITY.INDIA
HARARE	CITY.ZIMBABWE
QIQIHAR	CITY.CHINA
BARQUISIMETO	CITY.VENEZUELA
PORTO ALEGRE	CITY.BRAZIL
MULTAN	CITY.PAKISTAN
KYOTO	CITY.JAPAN
DENGZHOU	CITY.CHINA
GWANGJU	CITY.REPUBLIC OF KOREA
CIXI	CITY.CHINA
SHIRAZ	CITY.IRAN
NSUKKA	CITY.NIGERIA
CHANGDE	CITY.CHINA
PIZHOU	CITY.CHINA
DAVAO CITY	CITY.PHILIPPINES
LOME	CITY.TOGO
BAOJI	CITY.CHINA
SUQIAN	CITY.CHINA
LIUZHOU	CITY.CHINA
PUEBLA	CITY.MEXICO
BELÉM	CITY.BRAZIL
KHARKOV	CITY.UKRAINE
FUKUOKA	CITY.JAPAN
MARACAY	CITY.VENEZUELA
GUJRANWALA	CITY.PAKISTAN
EKATERINBURG	CITY.RUSSIA
TAIZHOU	CITY.CHINA
HYDERABAD	CITY.PAKISTAN
GOIÂNIA	CITY.BRAZIL
YICHANG	CITY.CHINA
BOZHOU	CITY.CHINA
SAN ANTONIO	CITY.USA
CONAKRY	CITY.GUINEA
MUNICH	CITY.GERMANY
FARIDABAD	CITY.INDIA
QUANZHOU	CITY.CHINA
AL-HASAKEH	CITY.SYRIA
MAPUTO	CITY.MOZAMBIQUE
PORT HARCOURT	CITY.NIGERIA
IDLEB	CITY.SYRIA
KAWASAKI	CITY.JAPAN
STOCKHOLM	CITY.SWEDEN
WENLING	CITY.CHINA
ALMATY	CITY.KAZAKHSTAN
ZIGONG	CITY.CHINA
FUSHUN	CITY.CHINA
SAN DIEGO	CITY.USA
MIANYANG	CITY.CHINA
PATIALA	CITY.INDIA
MILAN	CITY.ITALY
SHANTOU	CITY.CHINA
HEZE	CITY.CHINA
ULAANBAATAR	CITY.MONGOLIA
PALEMBANG	CITY.INDONESIA
GAZIANTEP	CITY.TURKEY
CHIFENG	CITY.CHINA
CÓRDOBA	CITY.ARGENTINA
LUBUMBASHI	CITY.DEMOCRATIC REPUBLIC OF THE CONGO
JUÁREZ	CITY.MEXICO
GUARULHOS	CITY.BRAZIL
KÉNITRA	CITY.MOROCCO
MEERUT	CITY.INDIA
WUHU	CITY.CHINA
MONTEVIDEO	CITY.URUGUAY
TIJUANA	CITY.MEXICO
LAIWU	CITY.CHINA
MEKKA	CITY.SAUDI-ARABIA
HAICHENG	CITY.CHINA
SOUTH TANGERANG	CITY.INDONESIA
YINCHUAN	CITY.CHINA
PRAGUE	CITY.CZECH REPUBLIC
GREATER ADELAIDE	CITY.AUSTRALIA
RUGAO	CITY.CHINA
NIZHNY NOVGOROD	CITY.RUSSIA
DALLAS	CITY.USA
PESHAWAR	CITY.PAKISTAN
NEIJIANG	CITY.CHINA
ADELAIDE	CITY.AUSTRALIA
ZHANGJIAGANG	CITY.CHINA
MARRAKECH	CITY.MOROCCO
KALYAN-DOMBIVALI	CITY.INDIA
KALYAN-DOMBIVALI	CITY.INDIA
LEÓN	CITY.MEXICO
YIXING	CITY.CHINA
FUQING	CITY.CHINA
YUEYANG	CITY.CHINA
COPENHAGEN	CITY.DENMARK
XINYANG	CITY.CHINA
LIAOCHENG	CITY.CHINA
VASAI-VIRAR	CITY.INDIA
MAOMING	CITY.CHINA
MOGADISHU	CITY.SOMALIA
BARRANQUILLA	CITY.COLOMBIA
SOFIA	CITY.BULGARIA
JIAXING	CITY.CHINA
VARANASI	CITY.INDIA
ZHENJIANG	CITY.CHINA
XINING	CITY.CHINA
TIANSHUI	CITY.CHINA
MAKASSAR	CITY.INDONESIA
SRINAGAR	CITY.INDIA
SAITAMA	CITY.JAPAN
EL-JADIDA	CITY.MOROCCO
CẦN THƠ	CITY.VIETNAM
CAN THO	CITY.VIETNAM
HUAZHOU	CITY.CHINA
TBILISI	CITY.GEORGIA
SAMARA	CITY.RUSSIA
SAMARSKAYA OBLAST	CITY.RUSSIA
MONROVIA	CITY.LIBERIA
NIAMEY	CITY.NIGER
KAZAN	CITY.RUSSIA
DINGZHOU	CITY.CHINA
HIROSHIMA	CITY.JAPAN
DHANBAD	CITY.INDIA
CHON BURI	CITY.THAILAND
OMSK	CITY.RUSSIA
COTONOU	CITY.BENIN
ZHUJI	CITY.CHINA
BAODING	CITY.CHINA
CAMPINAS	CITY.BRAZIL
JINGZHOU	CITY.CHINA
BATAM	CITY.INDONESIA
CHELYABINSK	CITY.RUSSIA
ANYANG	CITY.CHINA
RIZHAO	CITY.CHINA
ZAPOPAN	CITY.MEXICO
SHOUGUANG	CITY.CHINA
JODHPUR	CITY.INDIA
ULSAN	CITY.REPUBLIC OF KOREA
MONTERREY	CITY.MEXICO
HENGYANG	CITY.CHINA
AMRITSAR	CITY.INDIA
YUZHOU	CITY.CHINA
BAZHONG	CITY.CHINA
BAT DAMBANG	CITY.CAMBODIA
SANTO DOMINGO	CITY.DOMINICAN REPUBLIC
FÈS	CITY.MOROCCO
RAIPUR	CITY.INDIA
ABUJA	CITY.NIGERIA
BENIN CITY	CITY.NIGERIA
NAVI MUMBAI	CITY.INDIA
ALLAHABAD	CITY.INDIA
ZOUCHENG	CITY.CHINA
JINING	CITY.CHINA
HUAIBEI	CITY.CHINA
AHWAZ	CITY.IRAN
DEIR EL-ZOR	CITY.SYRIA
NEZAHUALCÓYOTL	CITY.MEXICO
ROSTOV-NA-DONU	CITY.RUSSIA
SUWON	CITY.REPUBLIC OF KOREA
CALGARY	CITY.CANADA
ZUNYI	CITY.CHINA
BENXI	CITY.CHINA
JINZHOU	CITY.CHINA
CHANGWON	CITY.REPUBLIC OF KOREA
DUBAI	CITY.UNITED ARAB EMIRATES
ZHUCHENG	CITY.CHINA
UFA	CITY.RUSSIA
SAMUT PRAKAN	CITY.THAILAND
JINHUA	CITY.CHINA
BIRMINGHAM	CITY.UNITED KINGDOM
QOM	CITY.IRAN
TAIXING	CITY.CHINA
ZHANGQIU	CITY.CHINA
SÃO LUÍS	CITY.BRAZIL
SAO LUIS	CITY.BRAZIL
COIMBATORE	CITY.INDIA
YEREWAN	CITY.ARMENIA
ZHUZHOU	CITY.CHINA
JABALPUR	CITY.INDIA
GWALIOR	CITY.INDIA
CIUDAD GUAYANA	CITY.VENEZUELA
LIANYUNGANG	CITY.CHINA
EZHOU	CITY.CHINA
VIJAYAWADA	CITY.INDIA
XINXIANG	CITY.CHINA
SHUBRA EL-KHEIMA	CITY.EGYPT
KONYA	CITY.TURKEY
COLOGNE	CITY.GERMANY
PINGDINGSHAN	CITY.CHINA
YINGKOU	CITY.CHINA
SÃO GONÇALO	CITY.BRAZIL
QINHUANGDAO	CITY.CHINA
SENDAI	CITY.JAPAN
LINHAI	CITY.CHINA
TRIPOLIS	CITY.LIBYA
PADANG	CITY.INDONESIA
SETTAT	CITY.MOROCCO
BOGOR	CITY.INDONESIA
GUATEMALA CITY	CITY.GUATEMALA
VOLGOGRAD	CITY.RUSSIA
MADURAI	CITY.INDIA
ANTANANARIVO	CITY.MADAGASCAR
WUWEI	CITY.CHINA
ABA	CITY.NIGERIA
KRASNOYARSK	CITY.RUSSIA
PERM	CITY.RUSSIA
BRUSSELS	CITY.BELGIUM
NDJAMENA	CITY.CHAD
HEZHOU	CITY.CHINA
MACEIÓ	CITY.BRAZIL
PANAMA DE PANAMA	CITY.PANAMA
SAN CRISTÓBAL	CITY.VENEZUELA
ZAOYANG	CITY.CHINA
NAPLES	CITY.ITALY
XIANGCHENG	CITY.CHINA
KATHMANDU	CITY.NEPAL
ANTALYA	CITY.TURKEY
SALÉ	CITY.MOROCCO
SEAM REAB	CITY.CAMBODIA
SAN JOSE	CITY.USA
MBUJI-MAYI	CITY.DEMOCRATIC REPUBLIC OF THE CONGO
VORONEZH	CITY.RUSSIA
ODESSA	CITY.UKRAINE
ARBIL	CITY.IRAQ
PORT-AU-PRINCE	CITY.HAITI
DNEPROPETROVSK	CITY.UKRAINE
KADUNA	CITY.NIGERIA
CAPE TOWN	CITY.SOUTH AFRICA
KITAKYŪSHŪ	CITY.JAPAN
MANAGUA	CITY.NICARAGUA
BÉNI-MELLAL	CITY.MOROCCO
SEONGNAM	CITY.REPUBLIC OF KOREA
CARTAGENA	CITY.COLOMBIA
GUILIN	CITY.CHINA
BENGBU	CITY.CHINA
QIDONG	CITY.CHINA
CHIANG MAI	CITY.THAILAND
SANTO DOMINGO EAST - SANTO DOMINGO ESTE	CITY.DOMINICAN REPUBLIC
MUDANJIANG	CITY.CHINA
GUWAHATI	CITY.INDIA
GOYANG	CITY.REPUBLIC OF KOREA
CHANDIGARH	CITY.INDIA
DONETSK	CITY.UKRAINE
DANYANG	CITY.CHINA
EDMONTON	CITY.CANADA
XIANGTAN	CITY.CHINA
BANGUI/ZONGO	CITY.CENTRAL AFRICAN REPUBLIC
EL ALTO	CITY.BOLIVIA
LATTAKIA	CITY.SYRIA
KAYSERI	CITY.TURKEY
ROSARIO	CITY.ARGENTINA
WUCHUAN	CITY.CHINA
FEICHENG	CITY.CHINA
XIANYANG	CITY.CHINA
LINFEN	CITY.CHINA
HUBLI-DHARWAD	CITY.INDIA
HANDAN	CITY.CHINA
CHIBA	CITY.JAPAN
HENGYANG	CITY.CHINA
OTTAWA–GATINEAU	CITY.CANADA
DRA'A	CITY.SYRIA
FREETOWN	CITY.SIERRA LEONE
XINYI	CITY.CHINA
MEDINA	CITY.SAUDI-ARABIA
TANGER	CITY.MOROCCO
WEIHAI	CITY.CHINA
HAIMEN	CITY.CHINA
SOWETO	CITY.SOUTH AFRICA
SAFI	CITY.MOROCCO
YONGIN	CITY.REPUBLIC OF KOREA
AMROHA	CITY.INDIA
KAIFENG	CITY.CHINA
MOMBASA	CITY.KENYA
MORADABAD	CITY.INDIA
ĐÀ NẴNG	CITY.VIETNAM
AUSTIN	CITY.USA
BISHKEK	CITY.KYRGYZSTAN
SHAOXING	CITY.CHINA
JIAMUSI	CITY.CHINA
DUQUE DE CAXIAS	CITY.BRAZIL
SUIHUA	CITY.CHINA
GURGAON	CITY.INDIA
BUCHEON	CITY.REPUBLIC OF KOREA
ALIGARH	CITY.INDIA
SOLAPUR	CITY.INDIA
LANGFANG	CITY.CHINA
CEBU CITY	CITY.PHILIPPINES
JIAOZUO	CITY.CHINA
TURIN	CITY.ITALY
AL-RAQQAH	CITY.SYRIA
KIGALI	CITY.RWANDA
RANCHI	CITY.INDIA
JALANDHAR	CITY.INDIA
NATAL	CITY.BRAZIL
KRASNODAR	CITY.RUSSIA
TEGUCIGALPA	CITY.HONDURAS
AREQUIPA	CITY.PERU
KERMANSHAH	CITY.IRAN
MARSEILLE	CITY.FRANCE
TIRUCHIRAPPALLI	CITY.INDIA
NOUAKCHOTT	CITY.MAURITANIA
DIYARBAKIR	CITY.TURKEY
MERSIN	CITY.TURKEY
INDIANAPOLIS	CITY.USA
CAMPO GRANDE	CITY.BRAZIL
ZHOUSHAN	CITY.CHINA
JACKSONVILLE	CITY.USA
TERESINA	CITY.BRAZIL
SARATOV	CITY.RUSSIA
BHUBANESWAR	CITY.INDIA
SAN FRANCISCO	CITY.USA
YIBIN	CITY.CHINA
LA PAZ	CITY.BOLIVIA
SAKAI	CITY.JAPAN
DENPASAR	CITY.INDONESIA
SALEM	CITY.INDIA
COLUMBUS	CITY.USA
MALANG	CITY.INDONESIA
WARANGAL	CITY.INDIA
MIRA-BHAYANDAR	CITY.INDIA
NIIGATA	CITY.JAPAN
KHULNA	CITY.BANGLADESH
SÃO BERNARDO DO CAMPO	CITY.BRAZIL
HAMAMATSU	CITY.JAPAN
CHIHUAHUA	CITY.MEXICO
JERUSALEM	CITY.ISRAEL
ZAMBOANGA CITY	CITY.PHILIPPINES
NOVA IGUAÇU	CITY.BRAZIL
VALENCIA	CITY.SPAIN
ORAN	CITY.ALGERIA
AMSTERDAM	CITY.NETHERLANDS
SONGKHLA	CITY.THAILAND
DANDONG	CITY.CHINA
NONTHABURI	CITY.THAILAND
DOHA	CITY.QATAR
ISLAMABAD	CITY.PAKISTAN
CHARLOTTE	CITY.USA
FORT WORTH	CITY.USA
NAUCALPAN	CITY.MEXICO
BANDAR LAMPUNG	CITY.INDONESIA
ZAGREB	CITY.CROATIA
MEKNÈS	CITY.MOROCCO
PANZHIHUA	CITY.CHINA
BIÊN HÒA	CITY.VIETNAM
VIENTIANE	CITY.LAOS
JOÃO PESSOA	CITY.BRAZIL
ANQING	CITY.CHINA
PUENTE ALTO	CITY.CHILE
HULUDAO	CITY.CHINA
MÉRIDA	CITY.MEXICO
TRUJILLO	CITY.PERU
POINTE NOIRE	CITY.REPUBLIC OF THE CONGO
PORT ELIZABETH	CITY.SOUTH AFRICA
SOULEIMANIYE	CITY.IRAQ
HAMHUNG	CITY.DEMOCRATIC PEOPLE'S REPUBLIC OF KOREA
ZAPOROZHYE	CITY.UKRAINE
ILORIN	CITY.NIGERIA
TAZA	CITY.MOROCCO
HUANGSHI	CITY.CHINA
QUETTA	CITY.PAKISTAN
NADOR	CITY.MOROCCO
SANTIAGO DE LOS CABALLEROS	CITY.DOMINICAN REPUBLIC
KRAKÓW	CITY.POLAND
PATHUM THANI	CITY.THAILAND
DONGYING	CITY.CHINA
DUSHANBE	CITY.TAJIKISTAN
TARTOUS	CITY.SYRIA
SHAOYANG	CITY.CHINA
THIRUVANANTHAPURAM	CITY.INDIA
JOHANNESBURG	CITY.SOUTH AFRICA
LEEDS	CITY.UNITED KINGDOM
LVOV	CITY.UKRAINE
DAMMAM	CITY.SAUDI-ARABIA
MRT	CITY.MAURITANIA
MA'ANSHAN	CITY.CHINA
QUJING	CITY.CHINA
LA PLATA	CITY.ARGENTINA
YINGKOU	CITY.CHINA
RIGA	CITY.LATVIA
ŁÓDŹ	CITY.POLAND
ARUSHA	CITY.TANZANIA
SAMARINDA	CITY.INDONESIA
KANANGA	CITY.DEMOCRATIC REPUBLIC OF THE CONGO
CHIŞINĂU	CITY.REPUBLIC OF MOLDOVA
KISHINEV	CITY.REPUBLIC OF MOLDOVA
SAN LUIS POTOSÍ	CITY.MEXICO
AGUASCALIENTES	CITY.MEXICO
ATHENS	CITY.GREECE
TOLYATTI	CITY.RUSSIA
PEKANBARU	CITY.INDONESIA
ANSAN	CITY.REPUBLIC OF KOREA
HERMOSILLO	CITY.MEXICO
BULAWAYO	CITY.ZIMBABWE
BHIWANDI	CITY.INDIA
SHIZUOKA	CITY.JAPAN
BINZHOU	CITY.CHINA
SALTILLO	CITY.MEXICO
SANTO ANDRÉ	CITY.BRAZIL
SAGAMIHARA	CITY.JAPAN
ZHANGZHOU	CITY.CHINA
BUKAVU	CITY.DEMOCRATIC REPUBLIC OF THE CONGO
SEVILLE	CITY.SPAIN
DUSCHANBE	CITY.TAJIKISTAN
SAHARANPUR	CITY.INDIA
KHON KAEN	CITY.THAILAND
DJIBOUTIBOUTI	CITY.DJIBOUTI
TUNIS	CITY.TUNISIA
MAKHACHKALA	CITY.RUSSIA
FRANKFURT AM MAIN	CITY.GERMANY
OKAYAMA	CITY.JAPAN
QUEBEC CITY	CITY.CANADA
TAGUIG	CITY.PHILIPPINES
OSASCO	CITY.BRAZIL
PRETORIA	CITY.SOUTH AFRICA
TOUBA MOSQUEE	CITY.SENEGAL
MEXICALI	CITY.MEXICO
XINGTAI	CITY.CHINA
DETROIT	CITY.USA
FUXIN	CITY.CHINA
PALERMO	CITY.ITALY
BARNAUL	CITY.RUSSIA
ADAN	CITY.YEMEN
SÃO JOSÉ DOS CAMPOS	CITY.BRAZIL
JOS	CITY.NIGERIA
JABOATÃO DOS GUARARAPES	CITY.BRAZIL
DEZHOU	CITY.CHINA
ANTIPOLO	CITY.PHILIPPINES
ZARIA	CITY.NIGERIA
YANGJIANG	CITY.CHINA
PANJIN	CITY.CHINA
CULIACÁN	CITY.MEXICO
EL PASO	CITY.USA
MAIDUGURI	CITY.NIGERIA
GUADALUPE	CITY.MEXICO
ACAPULCO	CITY.MEXICO
WINNIPEG	CITY.CANADA
HAMILTON	CITY.CANADA
KUMAMOTO	CITY.JAPAN
RABAT	CITY.MOROCCO
PASIG	CITY.PHILIPPINES
DURBAN	CITY.SOUTH AFRICA
LILONGWE	CITY.MALAWI
BEIHAI	CITY.CHINA
CHONGJIN	CITY.DEMOCRATIC PEOPLE'S REPUBLIC OF KOREA
ORUMIYEH	CITY.IRAN
CHEONGJU	CITY.REPUBLIC OF KOREA
BLANTYRE CITY	CITY.MALAWI
RIBEIRÃO PRETO	CITY.BRAZIL
KRYVY RIG	CITY.UKRAINE
LIAOYANG	CITY.CHINA
PUYANG	CITY.CHINA
UBERLÂNDIA	CITY.BRAZIL
MEMPHIS	CITY.USA
TLALNEPANTLA	CITY.MEXICO
BULAWAYO	CITY.ZIMBABWE
NAKHON RATCHASIMA	CITY.THAILAND
SEATTLE	CITY.USA
GUNTUR	CITY.INDIA
MAR DEL PLATA	CITY.ARGENTINA
DENVER	CITY.USA
JEONJU	CITY.REPUBLIC OF KOREA
COLOMBO	CITY.SRI LANKA
AMRAVATI	CITY.INDIA
WASHINGTON	CITY.USA
BOSTON	CITY.USA
TYUMEN	CITY.RUSSIA
BIKANER	CITY.INDIA
ZHAOQING	CITY.CHINA
CONTAGEM	CITY.BRAZIL
GANZHOU	CITY.CHINA
NOIDA	CITY.INDIA
RASHT	CITY.IRAN
ASTANA	CITY.KAZAKHSTAN
ULYANOVSK	CITY.RUSSIA
YULIN	CITY.CHINA
CÚCUTA	CITY.COLOMBIA
SOROCABA	CITY.BRAZIL
TASIKMALAYA	CITY.INDONESIA
NASHVILLE	CITY.USA
GOMA	CITY.DEMOCRATIC REPUBLIC OF THE CONGO
IZHEVSK	CITY.RUSSIA
WROCŁAW	CITY.POLAND
BENGASI	CITY.LIBYA
JAMSHEDPUR	CITY.INDIA
ESKIŞEHIR	CITY.TURKEY
CANCÚN	CITY.MEXICO
QUERÉTARO	CITY.MEXICO
BHILAI NAGAR	CITY.INDIA
BANJARMASIN	CITY.INDONESIA
VLADIVOSTOK	CITY.RUSSIA
ARACAJU	CITY.BRAZIL
BALTIMORE	CITY.USA
ZARAGOZA	CITY.SPAIN
KIRKUK	CITY.IRAQ
OSLO	CITY.NORWAY
COCHABAMBA	CITY.BOLIVIA
JINGJIANG	CITY.CHINA
ANYANG	CITY.REPUBLIC OF KOREA
HELSINKI	CITY.FINLAND
CHIMALHUACÁN	CITY.MEXICO
FEIRA DE SANTANA	CITY.BRAZIL
LIBREVILLE	CITY.GABON
OKLAHOMA CITY	CITY.USA
GENOA	CITY.ITALY
LOUISVILLE	CITY.USA
PORTLAND	CITY.USA
TORREÓN	CITY.MEXICO
CUTTACK	CITY.INDIA
KAGOSHIMA	CITY.JAPAN
AGADIR	CITY.MOROCCO
STUTTGART	CITY.GERMANY
LAS VEGAS	CITY.USA
SERREKUNDA	CITY.GAMBIA
CAGAYAN DE ORO	CITY.PHILIPPINES
IRKUTSK	CITY.RUSSIA
KOCHI	CITY.INDIA
ENUGU	CITY.NIGERIA
MILWAUKEE	CITY.USA
DÜSSELDORF	CITY.GERMANY
GLASGOW	CITY.UNITED KINGDOM
TÉTOUAN	CITY.MOROCCO
MORELIA	CITY.MEXICO
YAROSLAVL	CITY.RUSSIA
ZHANGZHOU	CITY.CHINA
BUJUMBURA	CITY.BURUNDI
BHAVNAGAR	CITY.INDIA
GOLD COAST-TWEED HEADS	CITY.AUSTRALIA
JIUJIANG	CITY.CHINA
KINGSTON	CITY.JAMAICA
OSOGBO	CITY.NIGERIA
KHABAROVSK	CITY.RUSSIA
REYNOSA	CITY.MEXICO
CHICLAYO	CITY.PERU
PORT SAID	CITY.EGYPT
BOUAKE	CITY.CÔTE D'IVOIRE
PARAÑAQUE	CITY.PHILIPPINES
FUNABASHI	CITY.JAPAN
SOLEDAD	CITY.COLOMBIA
NAMYANGJU	CITY.REPUBLIC OF KOREA
SKHIRATE-TÉMARA	CITY.MOROCCO
DEHRADUN	CITY.INDIA
SERANG	CITY.INDONESIA
BAHAWALPUR	CITY.PAKISTAN
DORTMUND	CITY.GERMANY
TLAQUEPAQUE	CITY.MEXICO
DASMARIÑAS	CITY.PHILIPPINES
MWANZA	CITY.TANZANIA
CUIABÁ	CITY.BRAZIL
VALENZUELA	CITY.PHILIPPINES
CHEONAN	CITY.REPUBLIC OF KOREA
POZNAŃ	CITY.POLAND
ORENBURG	CITY.RUSSIA
ESSEN	CITY.GERMANY
MACAO	CITY.MACAO
HACHIŌJI	CITY.JAPAN
SHIMKENT	CITY.KAZAKHSTAN
CIMAHI	CITY.INDONESIA
TOMSK	CITY.RUSSIA
BOBO-DIOULASSO	CITY.BURKINA FASO
ASANSOL	CITY.INDIA
CHUZHOU	CITY.CHINA
ZAHEDAN	CITY.IRAN
BALIKPAPAN	CITY.INDONESIA
MB JOHOR BAHRU	CITY.MALAYSIA
ALBUQUERQUE	CITY.USA
INEZGANE AIT MELLOUL	CITY.MOROCCO
JOINVILLE	CITY.BRAZIL
SARGODHA	CITY.PAKISTAN
KAWAGUCHI	CITY.JAPAN
LAS PIÑAS	CITY.PHILIPPINES
MACAU	CITY.CHINA
KHEMISSET	CITY.MOROCCO
JUIZ DE FORA	CITY.BRAZIL
NANDED-WAGHALA	CITY.INDIA
GOTHENBURG	CITY.SWEDEN
NOVOKUZNETSK	CITY.RUSSIA
SAN MIGUEL DE TUCUMÁN	CITY.ARGENTINA
BREMEN	CITY.GERMANY
NAKURU	CITY.KENYA
LONDRINA	CITY.BRAZIL
IBAGUÉ	CITY.COLOMBIA
AJMER	CITY.INDIA
MAWLAMYINE	CITY.MYANMAR
VILNIUS	CITY.LITHUANIA
ROTTERDAM	CITY.NETHERLANDS
KEMEROVO	CITY.RUSSIA
GENERAL SANTOS	CITY.PHILIPPINES
TUXTLA GUTIÉRREZ	CITY.MEXICO
CANGZHOU	CITY.CHINA
SKOPJE	CITY.MACEDONIA
HIMEJI	CITY.JAPAN
MÁLAGA	CITY.SPAIN
AKSU	CITY.CHINA
CIUDAD DE SALTA	CITY.ARGENTINA
KERMAN	CITY.IRAN
GAZA	CITY.PALESTINE
SAMSUN	CITY.TURKEY
LEIPZIG	CITY.GERMANY
IKORODU	CITY.NIGERIA
DRESDEN	CITY.GERMANY
JAMNAGAR	CITY.INDIA
SUEZ	CITY.EGYPT
DUBLIN	CITY.IRELAND
ABU DHABI	CITY.UNITED ARAB EMIRATES
RYAZAN	CITY.RUSSIA
BUCARAMANGA	CITY.COLOMBIA
ASTRAKHAN	CITY.RUSSIA
TUCSON	CITY.USA
HAMADAN	CITY.IRAN
NYALA	CITY.SUDAN
MATURÍN	CITY.VENEZUELA
TAIF	CITY.SAUDI-ARABIA
BACOOR	CITY.PHILIPPINES
PENZA	CITY.RUSSIA
SAN PEDRO SULA	CITY.HONDURAS
DURANGO	CITY.MEXICO
HANOVER	CITY.GERMANY
NABEREZHNYE TCHELNY	CITY.RUSSIA
KITWE	CITY.ZAMBIA
HWASEONG	CITY.REPUBLIC OF KOREA
POHANG	CITY.REPUBLIC OF KOREA
EL-MAHALLA EL-KUBRA	CITY.EGYPT
UJJAIN	CITY.INDIA
MATSUYAMA	CITY.JAPAN
SANGLI	CITY.INDIA
WARRI	CITY.NIGERIA
OUJDA	CITY.MOROCCO
LONI	CITY.INDIA
BACOLOD	CITY.PHILIPPINES
APARECIDA DE GOIÂNIA	CITY.BRAZIL
FRESNO	CITY.USA
HIGASHIŌSAKA	CITY.JAPAN
LIPETSK	CITY.RUSSIA
LISBON	CITY.PORTUGAL
KHOURIBGA	CITY.MOROCCO
UTSUNOMIYA	CITY.JAPAN
GIMHAE	CITY.REPUBLIC OF KOREA
JHANSI	CITY.INDIA
PONDICHERRY	CITY.INDIA
MB IPOH	CITY.MALAYSIA
KIROV	CITY.RUSSIA
NELLORE	CITY.INDIA
ZHOUKOU	CITY.CHINA
JAMMU	CITY.INDIA
NADJAF	CITY.IRAQ
PONTIANAK	CITY.INDONESIA
GOMEL	CITY.BELARUS
CIUDAD DE SANTA FE	CITY.ARGENTINA
ANANINDEUA	CITY.BRAZIL
SURAKARTA	CITY.INDONESIA
NUREMBERG	CITY.GERMANY
DENIZLI	CITY.TURKEY
MANCHESTER	CITY.UNITED KINGDOM
ŞANLIURFA	CITY.TURKEY
XUCHANG	CITY.CHINA
TULA	CITY.RUSSIA
NITERÓI	CITY.BRAZIL
GAROUA	CITY.CAMEROON
PORTO VELHO	CITY.BRAZIL
MYKOLAIV	CITY.UKRAINE
KANDAHAR	CITY.AFGHANISTAN
LARACHE	CITY.MOROCCO
TOLUCA	CITY.MEXICO
HEGANG	CITY.CHINA
CIUDAD LÓPEZ MATEOS	CITY.MEXICO
SOACHA	CITY.COLOMBIA
BELAGAVI	CITY.INDIA
AL-SHARJAH	CITY.UNITED ARAB EMIRATES
DUISBURG	CITY.GERMANY
YAZD	CITY.IRAN
TSHIKAPA	CITY.DEMOCRATIC REPUBLIC OF THE CONGO
RAURKELA	CITY.INDIA
MANGALURU	CITY.INDIA
SIALKOT	CITY.PAKISTAN
CUAUTITLÁN IZCALLI	CITY.MEXICO
LYON	CITY.FRANCE
ARAK	CITY.IRAN
UDON THANI	CITY.THAILAND
ARDABIL	CITY.IRAN
CAMPOS DOS GOYTACAZES	CITY.BRAZIL
MARIUPOL	CITY.UKRAINE
SACRAMENTO	CITY.USA
BELFORD ROXO	CITY.BRAZIL
SAMUT SAKHON	CITY.THAILAND
MATSUDO	CITY.JAPAN
NISHINOMIYA	CITY.JAPAN
PORTO-NOVO	CITY.BENIN
MAKATI	CITY.PHILIPPINES
SERRA	CITY.BRAZIL
SOKOTO	CITY.NIGERIA
DEN HAAG	CITY.NETHERLANDS
TIRUNELVELI	CITY.INDIA
CHEBOKSARY	CITY.RUSSIA
KURASHIKI	CITY.JAPAN
MALEGAON	CITY.INDIA
CAXIAS DO SUL	CITY.BRAZIL
ICHIKAWA	CITY.JAPAN
LONG BEACH	CITY.USA
SANTA MARTA	CITY.COLOMBIA
LIVERPOOL	CITY.UNITED KINGDOM
NANPING	CITY.CHINA
ŌITA	CITY.JAPAN
CIUDAD APODACA	CITY.MEXICO
KANSAS CITY	CITY.USA
BARCELONA	CITY.VENEZUELA
KARAGANDA	CITY.KAZAKHSTAN
VILA VELHA	CITY.BRAZIL
AL-MANSURA	CITY.EGYPT
AKURE	CITY.NIGERIA
PEREIRA	CITY.COLOMBIA
GAYA	CITY.INDIA
VILLAVICENCIO	CITY.COLOMBIA
FLORIANÓPOLIS	CITY.BRAZIL
LUGANSK	CITY.UKRAINE
FUKUYAMA	CITY.JAPAN
AMAGASAKI	CITY.JAPAN
SÃO JOÃO DE MERITI	CITY.BRAZIL
GDAŃSK	CITY.POLAND
ABEOKUTA	CITY.NIGERIA
MUNTINLUPA	CITY.PHILIPPINES
LUXOR	CITY.EGYPT
BISSAU	CITY.GUINEA-BISSAU
ANTWERP	CITY.BELGIUM
MESA	CITY.USA
CHIPATA	CITY.ZAMBIA
CHIANG RAI	CITY.THAILAND
AL-RAYYAN	CITY.QATAR
KANAZAWA	CITY.JAPAN
SAN JOSE DEL MONTE	CITY.PHILIPPINES
SANTO DOMINGO NORTH - SANTO DOMINGO NORTE	CITY.DOMINICAN REPUBLIC
CHAOZHOU	CITY.CHINA
MIXCO	CITY.GUATEMALA
UDAIPUR	CITY.INDIA
LISHUI	CITY.CHINA
NDOLA	CITY.ZAMBIA
MATAMOROS	CITY.MEXICO
KERBELA	CITY.IRAQ
NAGASAKI	CITY.JAPAN
MAUÁ	CITY.BRAZIL
EDINBURGH	CITY.UNITED KINGDOM
VIRGINIA BEACH	CITY.USA
BAMENDA	CITY.CAMEROON
CONSTANTINE	CITY.ALGERIA
ATLANTA	CITY.USA
MACAPÁ	CITY.BRAZIL
RAYONG	CITY.THAILAND
KITCHENER	CITY.CANADA
TIRUPPUR	CITY.INDIA
ZANZIBAR	CITY.TANZANIA
SAN NICOLÁS DE LOS GARZA	CITY.MEXICO
TOULOUSE	CITY.FRANCE
SOCHI	CITY.RUSSIA
TABUK	CITY.SAUDI-ARABIA
COLORADO SPRINGS	CITY.USA
SHEFFIELD	CITY.UNITED KINGDOM
BELLO	CITY.COLOMBIA
SÃO JOSÉ DO RIO PRETO	CITY.BRAZIL
KALININGRAD	CITY.RUSSIA
KALININGRADSKAYA OBLAST	CITY.RUSSIA
JAMBI	CITY.INDONESIA
HERAT	CITY.AFGHANISTAN
BANDAR-E-ABBAS	CITY.IRAN
DAVANAGERE	CITY.INDIA
OMAHA	CITY.USA
SANTOS	CITY.BRAZIL
VALLEDUPAR	CITY.COLOMBIA
KOZHIKODE	CITY.INDIA
MASERU	CITY.LESOTHO
HSINCHU	CITY.TAIWAN
RALEIGH	CITY.USA
SANTIAGO DE CUBA	CITY.CUBA
BRATISLAVA	CITY.SLOVAKIA
BRYANSK	CITY.RUSSIA
UIJEONGBU	CITY.REPUBLIC OF KOREA
SUKKUR	CITY.PAKISTAN
TANTA	CITY.EGYPT
KALASIN	CITY.THAILAND
PASTO	CITY.COLOMBIA
MONTERÍA	CITY.COLOMBIA
VERACRUZ	CITY.MEXICO
PYEONGTAEK	CITY.REPUBLIC OF KOREA
IQUITOS	CITY.PERU
AKOLA	CITY.INDIA
KURSK	CITY.RUSSIA
MATADI	CITY.DEMOCRATIC REPUBLIC OF THE CONGO
KURNOOL	CITY.INDIA
XALAPA	CITY.MEXICO
MATOLA	CITY.MOZAMBIQUE
ILOILO CITY	CITY.PHILIPPINES
MARIKINA	CITY.PHILIPPINES
PIURA	CITY.PERU
JEJU	CITY.REPUBLIC OF KOREA
YOKOSUKA	CITY.JAPAN
TOYAMA	CITY.JAPAN
NEWCASTLE-MAITLAND	CITY.AUSTRALIA
BRISTOL	CITY.UNITED KINGDOM
TOYOTA	CITY.JAPAN
MOGI DAS CRUZES	CITY.BRAZIL
TAKAMATSU	CITY.JAPAN
TIRANA	CITY.ALBANIA
MIAMI	CITY.USA
CILEGON	CITY.INDONESIA
NASSIRIYA	CITY.IRAQ
BOKARO STEEL CITY	CITY.INDIA
GUMI	CITY.REPUBLIC OF KOREA
ULAN-UDE	CITY.RUSSIA
MACHIDA	CITY.JAPAN
RAJAHMUNDRY	CITY.INDIA
SZCZECIN	CITY.POLAND
CUZCO	CITY.PERU
GIFU	CITY.JAPAN
KAHRAMANMARAŞ	CITY.TURKEY
CANBERRA-QUEANBEYAN	CITY.AUSTRALIA
BETIM	CITY.BRAZIL
BAUCHI	CITY.NIGERIA
UBON RATCHATHANI	CITY.THAILAND
TEL AVIV-YAFO	CITY.ISRAEL
SURAT THANI	CITY.THAILAND
MAGNITOGORSK	CITY.RUSSIA
BALLARI	CITY.INDIA
DIADEMA	CITY.BRAZIL
IVANOVO	CITY.RUSSIA
TONALÁ	CITY.MEXICO
STAVROPOL	CITY.RUSSIA
TVER	CITY.RUSSIA
PORT SUDANAN	CITY.SUDAN
OAKLAND	CITY.USA
HIRAKATA	CITY.JAPAN
MANADO	CITY.INDONESIA
PIETERMARITZBURG	CITY.SOUTH AFRICA
BRNO	CITY.CZECH REPUBLIC
CAMPINA GRANDE	CITY.BRAZIL
MATARAM	CITY.INDONESIA
RAJSHAHI	CITY.BANGLADESH
FUJISAWA	CITY.JAPAN
ZURICH	CITY.SWITZERLAND
MALATYA	CITY.TURKEY
SIHEUNG	CITY.REPUBLIC OF KOREA
MINNEAPOLIS	CITY.USA
JUBA	CITY.SUDAN
AGARTALA	CITY.INDIA
BHAGALPUR	CITY.INDIA
TULSA	CITY.USA
JUNDIAÍ	CITY.BRAZIL
BEIRA	CITY.MOZAMBIQUE
KASHGAR	CITY.CHINA
TALLINN	CITY.ESTONIA
ZARQA	CITY.JORDAN
ASYUT	CITY.EGYPT
MANIZALES	CITY.COLOMBIA
PASAY	CITY.PHILIPPINES
MARINGÁ	CITY.BRAZIL
NAMANGAN	CITY.UZBEKISTAN
MAKEYEVKA	CITY.UKRAINE
VILLA NUEVA	CITY.GUATEMALA
MONTES CLAROS	CITY.BRAZIL
CLEVELAND	CITY.USA
CARAPICUÍBA	CITY.BRAZIL
CALAMBA	CITY.PHILIPPINES
ISLAM SHAHR	CITY.IRAN
QASEMABAD	CITY.IRAN
KASHIWA	CITY.JAPAN
OLINDA	CITY.BRAZIL
YOGYAKARTA	CITY.INDONESIA
PIRACICABA	CITY.BRAZIL
TOYONAKA	CITY.JAPAN
ZANJAN	CITY.IRAN
WICHITA	CITY.USA
BENI	CITY.DEMOCRATIC REPUBLIC OF THE CONGO
ANTOFAGASTA	CITY.CHILE
BUENAVENTURA	CITY.COLOMBIA
PAJU	CITY.REPUBLIC OF KOREA
LATUR	CITY.INDIA
SAN JUAN	CITY.PUERTO RICO
QAZVIN	CITY.IRAN
MAZATLÁN	CITY.MEXICO
SEVASTOPOL	CITY.UKRAINE
CIUDAD BOLÍVAR	CITY.VENEZUELA
IRAPUATO	CITY.MEXICO
VEREENIGING	CITY.SOUTH AFRICA
ARLINGTON	CITY.USA
LARKANA	CITY.PAKISTAN
CARIACICA	CITY.BRAZIL
NEW ORLEANS	CITY.USA
BURAIDA	CITY.SAUDI-ARABIA
NAGANO	CITY.JAPAN
MURCIA	CITY.SPAIN
TOYOHASHI	CITY.JAPAN
TAKORADI	CITY.GHANA
DHULE	CITY.INDIA
CALABAR	CITY.NIGERIA
BURI RAM	CITY.THAILAND
ICHINOMIYA	CITY.JAPAN
KLANG	CITY.MALAYSIA
CUMANÁ	CITY.VENEZUELA
SHEIKHUPURA	CITY.PAKISTAN
SANANDAJ	CITY.IRAN
NUEVO LAREDO	CITY.MEXICO
KEELUNG	CITY.TAIWAN
CHAMIS MUSCHAIT	CITY.SAUDI-ARABIA
LAMPANG	CITY.THAILAND
WAKAYAMA	CITY.JAPAN
OKAZAKI	CITY.JAPAN
BOLOGNA	CITY.ITALY
VINNUTSYA	CITY.UKRAINE
BELGOROD	CITY.RUSSIA
SARAJEVO	CITY.BOSNIA-HERZEGOVINA
MIYAZAKI	CITY.JAPAN
BYDGOSZCZ	CITY.POLAND
MAZAR-I-SHARIF	CITY.AFGHANISTAN
MAROUA	CITY.CAMEROON
VAN	CITY.TURKEY
NARA	CITY.JAPAN
ERZURUM	CITY.TURKEY
MOHAMMEDIA	CITY.MOROCCO
BENONI	CITY.SOUTH AFRICA
NAMPO	CITY.DEMOCRATIC PEOPLE'S REPUBLIC OF KOREA
LONDON	CITY.CANADA
CHRISTCHURCH	CITY.NEW ZEALAND
PHRA NAKHON SI AYUTTHAYA	CITY.THAILAND
ROI ET	CITY.THAILAND
MOGILEV	CITY.BELARUS
CHIMBOTE	CITY.PERU
BAURU	CITY.BRAZIL
RIO BRANCO	CITY.BRAZIL
BAKERSFIELD	CITY.USA
KORBA	CITY.INDIA
WONSAN	CITY.DEMOCRATIC PEOPLE'S REPUBLIC OF KOREA
NIZHNY TAGIL	CITY.RUSSIA
ANÁPOLIS	CITY.BRAZIL
BOCHUM	CITY.GERMANY
NHA TRANG	CITY.VIETNAM
BEIRUT	CITY.LEBANON
SAMARKAND	CITY.UZBEKISTAN
KAUNAS	CITY.LITHUANIA
AL-OBEID	CITY.SUDAN
VITEBSK	CITY.BELARUS
BHILWARA	CITY.INDIA
SINUIJU	CITY.DEMOCRATIC PEOPLE'S REPUBLIC OF KOREA
PALMA DE MALLORCA	CITY.SPAIN
PHUKET	CITY.THAILAND
IGBIDU	CITY.NIGERIA
HUANCAYO	CITY.PERU
ARKHANGELSK	CITY.RUSSIA
OKENNE	CITY.NIGERIA
CHITUNGWIZA	CITY.ZIMBABWE
SIMFEROPOL	CITY.UKRAINE
XICO	CITY.MEXICO
FLORENCE	CITY.ITALY
LUBLIN	CITY.POLAND
BRAHMAPUR	CITY.INDIA
GWANGMYEONG	CITY.REPUBLIC OF KOREA
BARINAS	CITY.VENEZUELA
SUITA	CITY.JAPAN
TAKATSUKI	CITY.JAPAN
BILBAO	CITY.SPAIN
VILLAHERMOSA	CITY.MEXICO
MALABON	CITY.PHILIPPINES
SÃO VICENTE	CITY.BRAZIL
TAMPA	CITY.USA
KIKWIT	CITY.DEMOCRATIC REPUBLIC OF THE CONGO
KUANTAN	CITY.MALAYSIA
GENERAL ESCOBEDO	CITY.MEXICO
LIKASI	CITY.DEMOCRATIC REPUBLIC OF THE CONGO
CHITUNGWIZA	CITY.ZIMBABWE
VITÓRIA	CITY.BRAZIL
MUZAFFARPUR	CITY.INDIA
AHMEDNAGAR	CITY.INDIA
ASAHIKAWA	CITY.JAPAN
BLOEMFONTEIN	CITY.SOUTH AFRICA
LAPU-LAPU	CITY.PHILIPPINES
CABINDA	CITY.ANGOLA
OGBOMOSHO	CITY.NIGERIA
IWAKI	CITY.JAPAN
GRODNO	CITY.BELARUS
CAUCAIA	CITY.BRAZIL
VLADIMIR	CITY.RUSSIA
SANTO DOMINGO WEST - SANTO DOMINGO OESTE	CITY.DOMINICAN REPUBLIC
KOLLAM	CITY.INDIA
AL-SWEIDA	CITY.SYRIA
THESSALONIKI	CITY.GREECE
ITAQUAQUECETUBA	CITY.BRAZIL
KHORAMABAD	CITY.IRAN
MBEYA	CITY.TANZANIA
HONOLULU	CITY.USA
JHANG	CITY.PAKISTAN
TARAZ	CITY.KAZAKHSTAN
KOVROV	CITY.RUSSIA
RAGHUNATHGANJ	CITY.INDIA
SAN MIGUELITO	CITY.PANAMA
TANCHON	CITY.DEMOCRATIC PEOPLE'S REPUBLIC OF KOREA
KISANGANI	CITY.DEMOCRATIC REPUBLIC OF THE CONGO
AURORA	CITY.USA
ANAHEIM	CITY.USA
KATHLEHONG	CITY.SOUTH AFRICA
KALUGA	CITY.RUSSIA
KEMPTON PARK	CITY.SOUTH AFRICA
WUPPERTAL	CITY.GERMANY
NICE	CITY.FRANCE
KŌCHI	CITY.JAPAN
ANNABA	CITY.ALGERIA
CARUARU	CITY.BRAZIL
PELOTAS	CITY.BRAZIL
GOMBE	CITY.NIGERIA
TAKASAKI	CITY.JAPAN
CELAYA	CITY.MEXICO
VITÓRIA DA CONQUISTA	CITY.BRAZIL
BUÔN MA THUỘT	CITY.VIETNAM
CANOAS	CITY.BRAZIL
HUẾ	CITY.VIETNAM
NAKHON PATHOM	CITY.THAILAND
UMLAZI	CITY.SOUTH AFRICA
FRANCA	CITY.BRAZIL
KŌRIYAMA	CITY.JAPAN
CUERNAVACA	CITY.MEXICO
TOKOROZAWA	CITY.JAPAN
ISMAILIA	CITY.EGYPT
ANDIZHAN	CITY.UZBEKISTAN
PLOVDIV	CITY.BULGARIA
NEIVA	CITY.COLOMBIA
ADO EKITI	CITY.NIGERIA
JINJU	CITY.REPUBLIC OF KOREA
AMARA	CITY.IRAQ
KUPANG	CITY.INDONESIA
CARREFOUR	CITY.HAITI
ABAKALIKI	CITY.NIGERIA
KAWAGOE	CITY.JAPAN
VARNA	CITY.BULGARIA
PONTA GROSSA	CITY.BRAZIL
ALICANTE	CITY.SPAIN
SANTA ANA	CITY.USA
BLUMENAU	CITY.BRAZIL
DIWANIYA	CITY.IRAQ
TEPIC	CITY.MEXICO
KHERSON	CITY.UKRAINE
WESTERN CONURBATION	CITY.KENYA
KATSINA	CITY.NIGERIA
CUENCA	CITY.ECUADOR
BLIDA	CITY.ALGERIA
KUT	CITY.IRAQ
ELAZIĞ	CITY.TURKEY
MANDAUE	CITY.PHILIPPINES
AMBON	CITY.INDONESIA
MINNA	CITY.NIGERIA
LEICESTER	CITY.UNITED KINGDOM
SMOLENSK	CITY.RUSSIA
BILASPUR	CITY.INDIA
THÁI NGUYÊN	CITY.VIETNAM
CHITA	CITY.RUSSIA
GORGAN	CITY.IRAN
AKITA	CITY.JAPAN
ŌTSU	CITY.JAPAN
ONDO	CITY.NIGERIA
BIELEFELD	CITY.GERMANY
MANDALUYONG	CITY.PHILIPPINES
TIELING	CITY.CHINA
PAVLODAR	CITY.KAZAKHSTAN
AL AIN	CITY.UNITED ARAB EMIRATES
GBOKO	CITY.NIGERIA
FAYYUM	CITY.EGYPT
VOLZHSKY	CITY.RUSSIA
VLADIKAVKAZ	CITY.RUSSIA
OSETINSKAYA ASSR	CITY.RUSSIA
KURGAN	CITY.RUSSIA
SARANSK	CITY.RUSSIA
ANGELES	CITY.PHILIPPINES
PETROLINA	CITY.BRAZIL
BAFOUSSAM	CITY.CAMEROON
BATMAN	CITY.TURKEY
BREST	CITY.BELARUS
ILIGAN	CITY.PHILIPPINES
IXTAPALUCA	CITY.MEXICO
GANJA	CITY.AZERBAIJAN
LOKOJA	CITY.NIGERIA
OYO	CITY.NIGERIA
SUMGAYIT	CITY.AZERBAIJAN
SHAHJAHANPUR	CITY.INDIA
KATOWICE	CITY.POLAND
WONJU	CITY.REPUBLIC OF KOREA
SURGUT	CITY.RUSSIA
BARI	CITY.ITALY
LONG XUYÊN	CITY.VIETNAM
PAULISTA	CITY.BRAZIL
KAECHON	CITY.DEMOCRATIC PEOPLE'S REPUBLIC OF KOREA
RIBEIRÃO DAS NEVES	CITY.BRAZIL
UBERABA	CITY.BRAZIL
BAGUIO	CITY.PHILIPPINES
OREL	CITY.RUSSIA
KOSHIGAYA	CITY.JAPAN
VALLADOLID	CITY.SPAIN
SIVAS	CITY.TURKEY
ST. LOUIS	CITY.USA
TARLAC CITY	CITY.PHILIPPINES
MAEBASHI	CITY.JAPAN
RATCHABURI	CITY.THAILAND
BUNIA	CITY.DEMOCRATIC REPUBLIC OF THE CONGO
CENTRAL COAST	CITY.AUSTRALIA
MOSHI	CITY.TANZANIA
MANISA	CITY.TURKEY
RIVERSIDE	CITY.USA
CORPUS CHRISTI	CITY.USA
VICTORIA	CITY.CANADA
SAKON NAKHON	CITY.THAILAND
IAŞI	CITY.ROMANIA
THRISSUR	CITY.INDIA
CARDIFF	CITY.UNITED KINGDOM
ALWAR	CITY.INDIA
CHEREPOVETS	CITY.RUSSIA
HUAMBO	CITY.ANGOLA
BOA VISTA	CITY.BRAZIL
CÓRDOBA	CITY.SPAIN
OSTRAVA	CITY.CZECH REPUBLIC
CIUDAD DE CORRIENTES	CITY.ARGENTINA
KHAYELITSA	CITY.SOUTH AFRICA
NAHA	CITY.JAPAN
VOLOGDA	CITY.RUSSIA
SEMIPALATINSK	CITY.KAZAKHSTAN
CATANIA	CITY.ITALY
AKTOBE	CITY.KAZAKHSTAN
KAKINADA	CITY.INDIA
TIMIȘOARA	CITY.ROMANIA
SAN BERNARDO	CITY.CHILE
KOLWEZI	CITY.DEMOCRATIC REPUBLIC OF THE CONGO
UVIRA	CITY.DEMOCRATIC REPUBLIC OF THE CONGO
BONN	CITY.GERMANY
QUY NHƠN	CITY.VIETNAM
NIZAMABAD	CITY.INDIA
RAHIMYAR KHAN	CITY.PAKISTAN
NOVI SAD	CITY.SERBIA
BUTUAN	CITY.PHILIPPINES
ST. CATHARINES–NIAGARA	CITY.CANADA
CASCAVEL	CITY.BRAZIL
GUARUJÁ	CITY.BRAZIL
SAGAR	CITY.INDIA
GUJRAT	CITY.PAKISTAN
ZAGAZIG	CITY.EGYPT
IKSAN	CITY.REPUBLIC OF KOREA
KAESONG	CITY.DEMOCRATIC PEOPLE'S REPUBLIC OF KOREA
LEXINGTON	CITY.USA
MARDAN	CITY.PAKISTAN
SARIWON	CITY.DEMOCRATIC PEOPLE'S REPUBLIC OF KOREA
KASSALA	CITY.SUDAN
YOKKAICHI	CITY.JAPAN
CLUJ-NAPOCA	CITY.ROMANIA
AOMORI	CITY.JAPAN
PITTSBURGH	CITY.USA
TUMKUR	CITY.INDIA
SANTA ELENA	CITY.ECUADOR
BATANGAS CITY	CITY.PHILIPPINES
NOVOROSSIYSK	CITY.RUSSIA
CIUDAD VICTORIA	CITY.MEXICO
KURUME	CITY.JAPAN
KUNDUZ	CITY.AFGHANISTAN
MURMANSK	CITY.RUSSIA
COVENTRY	CITY.UNITED KINGDOM
KOTA KINABALU	CITY.MALAYSIA
NAMPULA	CITY.MOZAMBIQUE
CONSTANŢA	CITY.ROMANIA
IMUS	CITY.PHILIPPINES
KINGSTON UPON HULL	CITY.UNITED KINGDOM
HISAR	CITY.INDIA
ANCHORAGE	CITY.USA
CAMAGÜEY	CITY.CUBA
KASUGAI	CITY.JAPAN
PALMIRA	CITY.COLOMBIA
WAD MADANY	CITY.SUDAN
MORIOKA	CITY.JAPAN
MÜNSTER	CITY.GERMANY
SYLHET	CITY.BANGLADESH
TAUBATÉ	CITY.BRAZIL
CABIMAS	CITY.VENEZUELA
KARLSRUHE	CITY.GERMANY
YAKUTSK	CITY.RUSSIA
UST-KAMENOGORSK	CITY.KAZAKHSTAN
SUKABUMI	CITY.INDONESIA
CRAIOVA	CITY.ROMANIA
CIUDAD OBREGÓN	CITY.MEXICO
CIREBON	CITY.INDONESIA
STOCKTON	CITY.USA
PETRÓPOLIS	CITY.BRAZIL
HALIFAX	CITY.CANADA
CINCINNATI	CITY.USA
SUNCHON	CITY.DEMOCRATIC PEOPLE'S REPUBLIC OF KOREA
TAMPICO	CITY.MEXICO
KASUR	CITY.PAKISTAN
MANNHEIM	CITY.GERMANY
SARI	CITY.IRAN
TONGI	CITY.BANGLADESH
İZMIT	CITY.TURKEY
SAINT PAUL	CITY.USA
ROHTAK	CITY.INDIA
SAN PEDRO	CITY.PHILIPPINES
PANIPAT	CITY.INDIA
LIMEIRA	CITY.BRAZIL
DARBHANGA	CITY.INDIA
VIGO	CITY.SPAIN
BRADFORD	CITY.UNITED KINGDOM
PRAIA GRANDE	CITY.BRAZIL
ARMENIA	CITY.COLOMBIA
IFE	CITY.NIGERIA
SÃO JOSÉ DOS PINHAIS	CITY.BRAZIL
YEOSU	CITY.REPUBLIC OF KOREA
KANCHANABURI	CITY.THAILAND
AKASHI	CITY.JAPAN
BIAŁYSTOK	CITY.POLAND
PALU	CITY.INDONESIA
AIZAWL	CITY.INDIA
LUQUE	CITY.PARAGUAY
OSHAWA	CITY.CANADA
GEBZE	CITY.TURKEY
MALARD	CITY.IRAN
GALAŢI	CITY.ROMANIA
SANTARÉM	CITY.BRAZIL
CHERNIGOV	CITY.UKRAINE
SAN SALVADOR	CITY.EL SALVADOR
SEREMBAN	CITY.MALAYSIA
POLTAVA	CITY.UKRAINE
BATNA	CITY.ALGERIA
FUKUSHIMA	CITY.JAPAN
HILLA	CITY.IRAQ
TSU	CITY.JAPAN
VIÑA DEL MAR	CITY.CHILE
UTRECHT	CITY.NETHERLANDS
HOLGUÍN	CITY.CUBA
SAN JOSE	CITY.COSTA RICA
MAKURDI	CITY.NIGERIA
SAN LORENZO	CITY.PARAGUAY
HUFUF	CITY.SAUDI-ARABIA
ICHALKARANJI	CITY.INDIA
GUNPO	CITY.REPUBLIC OF KOREA
TIRUPATI	CITY.INDIA
KARNAL	CITY.INDIA
SUNSHINE COAST	CITY.AUSTRALIA
SHIMONOSEKI	CITY.JAPAN
SAN FERNANDO	CITY.PHILIPPINES
BATHINDA	CITY.INDIA
AL-MUBARRAZ	CITY.SAUDI-ARABIA
NANTES	CITY.FRANCE
SANTA ROSA	CITY.PHILIPPINES
TAMALE	CITY.GHANA
ELDORET	CITY.KENYA
PYONGSONG	CITY.DEMOCRATIC PEOPLE'S REPUBLIC OF KOREA
MOSSORÓ	CITY.BRAZIL
TACNA	CITY.PERU
DELMAS	CITY.HAITI
SUCRE	CITY.BOLIVIA
CHERKASSY	CITY.UKRAINE
QODS	CITY.IRAN
LIPA	CITY.PHILIPPINES
BIÑAN	CITY.PHILIPPINES
WOLLONGONG	CITY.AUSTRALIA
VINH	CITY.VIETNAM
RAMADI	CITY.IRAQ
SUZANO	CITY.BRAZIL
TOLEDO	CITY.USA
CIUDAD NICOLÁS ROMERO	CITY.MEXICO
RAMPUR	CITY.INDIA
MBANDAKA	CITY.DEMOCRATIC REPUBLIC OF THE CONGO
PEKALONGAN	CITY.INDONESIA
CAMAÇARI	CITY.BRAZIL
TAMBOV	CITY.RUSSIA
NAGAOKA	CITY.JAPAN
MALMÖ	CITY.SWEDEN
AL-GADARIF	CITY.SUDAN
ENSENADA	CITY.MEXICO
THIES	CITY.SENEGAL
CIUDAD DEL ESTE	CITY.PARAGUAY
LJUBLJANA	CITY.SLOVENIA
GREENSBORO	CITY.USA
ICHIHARA	CITY.JAPAN
ROODEPOORT	CITY.SOUTH AFRICA
LHASA	CITY.CHINA
SAN CRISTÓBAL	CITY.DOMINICAN REPUBLIC
BAGO	CITY.MYANMAR
NEWARK	CITY.USA
VŨNG TÀU	CITY.VIETNAM
BRAŞOV	CITY.ROMANIA
COACALCO DE BERRIOZÁBAL	CITY.MEXICO
PATHEIN	CITY.MYANMAR
HAKODATE	CITY.JAPAN
PUNTO FIJO	CITY.VENEZUELA
GOVERNADOR VALADARES	CITY.BRAZIL
AUGSBURG	CITY.GERMANY
GUNSAN	CITY.REPUBLIC OF KOREA
GROZNYI	CITY.RUSSIA
BELFAST	CITY.UNITED KINGDOM
WINDSOR	CITY.CANADA
ASAN	CITY.REPUBLIC OF KOREA
KASHAN	CITY.IRAN
SOYAPANGO	CITY.EL SALVADOR
STERLITAMAK	CITY.RUSSIA
GORLOVKA	CITY.UKRAINE
SANTA MARIA	CITY.BRAZIL
BAHÍA BLANCA	CITY.ARGENTINA
RESISTENCIA	CITY.ARGENTINA
PLANO	CITY.USA
SHIVAMOGGA	CITY.INDIA
VICENTE LÓPEZ	CITY.ARGENTINA
RATLAM	CITY.INDIA
WIESBADEN	CITY.GERMANY
LA VEGA	CITY.DOMINICAN REPUBLIC
ASWAN	CITY.EGYPT
BRIGHTON & HOVE	CITY.UNITED KINGDOM
HAEJU	CITY.DEMOCRATIC PEOPLE'S REPUBLIC OF KOREA
YAO	CITY.JAPAN
CHUNCHEON	CITY.REPUBLIC OF KOREA
MODINAGAR	CITY.INDIA
POPAYÁN	CITY.COLOMBIA
CABANATUAN	CITY.PHILIPPINES
MOROGORO	CITY.TANZANIA
SUNCHEON	CITY.REPUBLIC OF KOREA
IBARAKI	CITY.JAPAN
PUERTO LA CRUZ	CITY.VENEZUELA
COTABATO CITY	CITY.PHILIPPINES
STRASBOURG	CITY.FRANCE
SUMY	CITY.UKRAINE
VENICE	CITY.ITALY
CHIAYI	CITY.TAIWAN
HAIFA	CITY.ISRAEL
HENDERSON	CITY.USA
GRAVATAÍ	CITY.BRAZIL
KOSTROMA	CITY.RUSSIA
GIJÓN	CITY.SPAIN
ZHITOMIR	CITY.UKRAINE
LINCOLN	CITY.USA
DURG	CITY.INDIA
FUKUI	CITY.JAPAN
KEDIRI	CITY.INDONESIA
SANTA CATARINA	CITY.MEXICO
TABOÃO DA SERRA	CITY.BRAZIL
SHILLONG	CITY.INDIA
KAKOGAWA	CITY.JAPAN
SINCELEJO	CITY.COLOMBIA
YANGSAN	CITY.REPUBLIC OF KOREA
PETROZAVODSK	CITY.RUSSIA
HA'IL	CITY.SAUDI-ARABIA
DAMIETTA	CITY.EGYPT
GWANGJU	CITY.REPUBLIC OF KOREA
TOKUSHIMA	CITY.JAPAN
BERGEN	CITY.NORWAY
DJELFA	CITY.ALGERIA
VÁRZEA GRANDE	CITY.BRAZIL
BALIKESIR	CITY.TURKEY
YOSHKAR-OLA	CITY.RUSSIA
NAKHON SI THAMMARAT	CITY.THAILAND
PALMAS	CITY.BRAZIL
TEMUCO	CITY.CHILE
NALTCHIK	CITY.RUSSIA
GYEONGJU	CITY.REPUBLIC OF KOREA
POKHARA	CITY.NEPAL
IMPHAL	CITY.INDIA
URUAPAN	CITY.MEXICO
GUARENAS	CITY.VENEZUELA
RANGPUR	CITY.BANGLADESH
SANTA ANA	CITY.EL SALVADOR
MITO	CITY.JAPAN
FLORIDABLANCA	CITY.COLOMBIA
JUAZEIRO DO NORTE	CITY.BRAZIL
FOZ DO IGUAÇU	CITY.BRAZIL
BOKSBURG	CITY.SOUTH AFRICA
LAAYOUNE	CITY.MOROCCO
LAMPHUN	CITY.THAILAND
HAPUR	CITY.INDIA
RANIPET	CITY.INDIA
ANANTAPUR	CITY.INDIA
SUMARÉ	CITY.BRAZIL
VOLTA REDONDA	CITY.BRAZIL
KHMELNITSKY	CITY.UKRAINE
MUTARE	CITY.ZIMBABWE
NGAOUNDÉRÉ	CITY.CAMEROON
ITAGÜI	CITY.COLOMBIA
KARAMAY	CITY.CHINA
ARRAH	CITY.INDIA
NIZHNEVARTOVSK	CITY.RUSSIA
GIMPO	CITY.REPUBLIC OF KOREA
KARIMNAGAR	CITY.INDIA
JULIACA	CITY.PERU
HIRATSUKA	CITY.JAPAN
NIŠ	CITY.SERBIA
BARUERI	CITY.BRAZIL
GOLESTAN	CITY.IRAN
SOLTANABAD	CITY.IRAN
PARBHANI	CITY.INDIA
STOKE-ON-TRENT	CITY.UNITED KINGDOM
KOMSOMOLSK-NA-AMURE	CITY.RUSSIA
MISRATA	CITY.LIBYA
EMBU DAS ARTES	CITY.BRAZIL
BUFFALO	CITY.USA
OSH	CITY.KYRGYZSTAN
LUBANGO	CITY.ANGOLA
GELSENKIRCHEN	CITY.GERMANY
BENGKULU	CITY.INDONESIA
GÓMEZ PALACIO	CITY.MEXICO
MONTPELLIER	CITY.FRANCE
JERSEY CITY	CITY.USA
MARABÁ	CITY.BRAZIL
IJEBU ODE	CITY.NIGERIA
STARY OSKOL	CITY.RUSSIA
ETAWAH	CITY.INDIA
CHULA VISTA	CITY.USA
LOS MOCHIS	CITY.MEXICO
PACHUCA	CITY.MEXICO
FORT WAYNE	CITY.USA
ĐÀ LẠT	CITY.VIETNAM
TAGANROG	CITY.RUSSIA
ORLANDO	CITY.USA
MÖNCHENGLADBACH	CITY.GERMANY
YAMAGATA	CITY.JAPAN
SYKTIVKAR	CITY.RUSSIA
IPATINGA	CITY.BRAZIL
BERTOUA	CITY.CAMEROON
CHERNOVTSY	CITY.UKRAINE
OAXACA	CITY.MEXICO
SOLEDAD DE GRACIANO SÁNCHEZ	CITY.MEXICO
ALAJUELA	CITY.COSTA RICA
SASEBO	CITY.JAPAN
PORT MORESBY	CITY.PAPUA NEW GUINEA
GDYNIA	CITY.POLAND
VERONA	CITY.ITALY
POSADAS	CITY.ARGENTINA
ESPOO	CITY.FINLAND
IMPERATRIZ	CITY.BRAZIL
SÉTIF	CITY.ALGERIA
MESSINA	CITY.ITALY
KANGGYE	CITY.DEMOCRATIC PEOPLE'S REPUBLIC OF KOREA
VALPARAÍSO	CITY.CHILE
LOS TEQUES	CITY.VENEZUELA
WOLVERHAMPTON	CITY.UNITED KINGDOM
BEGUSARAI	CITY.INDIA
VIAMÃO	CITY.BRAZIL
RẠCH GIÁ	CITY.VIETNAM
IRBID	CITY.JORDAN
MÉRIDA	CITY.VENEZUELA
GRAZ	CITY.AUSTRIA
NEW DELHI	CITY.INDIA
ST. PETERSBURG	CITY.USA
LOS ALCARRIZOS	CITY.DOMINICAN REPUBLIC
NOTTINGHAM	CITY.UNITED KINGDOM
SHAHRIAR	CITY.IRAN
CHANDLER	CITY.USA
NAVOTAS	CITY.PHILIPPINES
CZĘSTOCHOWA	CITY.POLAND
SAN PABLO	CITY.PHILIPPINES
SFAX	CITY.TUNISIA
TEHUACÁN	CITY.MEXICO
DZERZHINSK	CITY.RUSSIA
NIZHEGORODSKAYA OBLAST	CITY.RUSSIA
FUCHUFUCHŪ	CITY.JAPAN
CABUYAO	CITY.PHILIPPINES
DEZFUL	CITY.IRAN
NOVO HAMBURGO	CITY.BRAZIL
GHENT	CITY.BELGIUM
DNEPRODZERZHINSK	CITY.UKRAINE
L'HOSPITALET	CITY.SPAIN
LAREDO	CITY.USA
DIRĒ DAWA	CITY.ETHIOPIA
MACHAKOS	CITY.KENYA
BIRNIN KEBBI	CITY.NIGERIA
BRAUNSCHWEIG	CITY.GERMANY
SAN MIGUEL	CITY.EL SALVADOR
DAMANHUR	CITY.EGYPT
ILESHA	CITY.NIGERIA
RIVNE	CITY.UKRAINE
NADSCHRAN	CITY.SAUDI-ARABIA
AL-MINYA	CITY.EGYPT
LUCENA	CITY.PHILIPPINES
NORFOLK	CITY.USA
KURE	CITY.JAPAN
MP KOTA BHARU	CITY.MALAYSIA
DURHAM	CITY.USA
PETALING JAYA	CITY.MALAYSIA
CIUDAD OJEDA	CITY.VENEZUELA
PHATTHALUNG	CITY.THAILAND
MEIKTILA	CITY.MYANMAR
KHOMEINI SHAHR	CITY.IRAN
NASSAU	CITY.BAHAMAS
MOKPO	CITY.REPUBLIC OF KOREA
MERLO	CITY.ARGENTINA
PLYMOUTH	CITY.UNITED KINGDOM
GYEONGSAN	CITY.REPUBLIC OF KOREA
URALSK	CITY.KAZAKHSTAN
DERA GHAZI KHAN	CITY.PAKISTAN
MADISON	CITY.USA
WAH CANTONMENT	CITY.PAKISTAN
CHANTHABURI	CITY.THAILAND
PARAMARIBO	CITY.SURINAME
PORTO	CITY.PORTUGAL
TAGUM	CITY.PHILIPPINES
NAZRĒT	CITY.ETHIOPIA
BRATSK	CITY.RUSSIA
A CORUÑA	CITY.SPAIN
OJO DE AGUA	CITY.MEXICO
CHEMNITZ	CITY.GERMANY
RANCAGUA	CITY.CHILE
KADAPA	CITY.INDIA
NARAYANGANJ	CITY.BANGLADESH
AACHEN	CITY.GERMANY
HACHINOHE	CITY.JAPAN
MACHALA	CITY.ECUADOR
KIEL	CITY.GERMANY
ORSK	CITY.RUSSIA
NAM ĐỊNH	CITY.VIETNAM
LAFIA	CITY.NIGERIA
RIOHACHA	CITY.COLOMBIA
IVANO-FRANKOVSK	CITY.UKRAINE
BORUJERD	CITY.IRAN
GRANADA	CITY.SPAIN
MEK'ELĒ	CITY.ETHIOPIA
SIKASSO	CITY.MALI
ANJU	CITY.DEMOCRATIC PEOPLE'S REPUBLIC OF KOREA
SAGA	CITY.JAPAN
TEGAL	CITY.INDONESIA
LUBBOCK	CITY.USA
ICA	CITY.PERU
SARABURI	CITY.THAILAND
KIROVOGRAD	CITY.UKRAINE
KOSTY	CITY.SUDAN
NEYSHABUR	CITY.IRAN
SAHIWAL	CITY.PAKISTAN
BORDEAUX	CITY.FRANCE
NEYAGAWA	CITY.JAPAN
SÃO CARLOS	CITY.BRAZIL
BALASHIKHA	CITY.RUSSIA
TARSUS	CITY.TURKEY
BINJAI	CITY.INDONESIA
SHAKHTY	CITY.RUSSIA
SŌKA	CITY.JAPAN
RAMAGUNDAM	CITY.INDIA
TEMBISA	CITY.SOUTH AFRICA
BUKHARA	CITY.UZBEKISTAN
FUJI	CITY.JAPAN
TOKCHON	CITY.DEMOCRATIC PEOPLE'S REPUBLIC OF KOREA
MAIMANSINGH	CITY.BANGLADESH
KASUKABE	CITY.JAPAN
IRVINE	CITY.USA
NAWABSHAH	CITY.PAKISTAN
WINSTON–SALEM	CITY.USA
KENDARI	CITY.INDONESIA
COATZACOALCOS	CITY.MEXICO
PARNAMIRIM	CITY.BRAZIL
PARANÁ	CITY.ARGENTINA
LOP BURI	CITY.THAILAND
DURÁN	CITY.ECUADOR
KÜTAHYA	CITY.TURKEY
MINGAORA	CITY.PAKISTAN
NIZHNEKAMSK	CITY.RUSSIA
CHANGHUA	CITY.TAIWAN
MALOLOS	CITY.PHILIPPINES
GLENDALE	CITY.USA
GARLAND	CITY.USA
TANGA	CITY.TANZANIA
SOUTHAMPTON	CITY.UNITED KINGDOM
TRABZON	CITY.TURKEY
PLEIKU	CITY.VIETNAM
PURWOKERTO	CITY.INDONESIA
KOŠICE	CITY.SLOVAKIA
MAGÉ	CITY.BRAZIL
RISHON LEZIYYON	CITY.ISRAEL
WINDHOEK	CITY.NAMIBIA
HIALEAH	CITY.USA
RENO	CITY.USA
SAN PEDRO DE MACORIS	CITY.DOMINICAN REPUBLIC
ADAPAZARI	CITY.TURKEY
GEOJE	CITY.REPUBLIC OF KOREA
NONG KHAI	CITY.THAILAND
READING	CITY.UNITED KINGDOM
HAFAR AL-BATIN	CITY.SAUDI-ARABIA
ANGARSK	CITY.RUSSIA
KASAMA	CITY.ZAMBIA
GABORONE	CITY.BOTSWANA
HALLE	CITY.GERMANY
SAALE	CITY.GERMANY
SABZEWAR	CITY.IRAN
SAN SALVADOR DE JUJUY	CITY.ARGENTINA
MAGDEBURG	CITY.GERMANY
CHIGASAKI	CITY.JAPAN
QUILMES	CITY.ARGENTINA
CIUDAD DE SANTIAGO DEL ESTERO	CITY.ARGENTINA
CHESAPEAKE	CITY.USA
MARÍLIA	CITY.BRAZIL
GILBERT	CITY.USA
PALI	CITY.INDIA
SETE LAGOAS	CITY.BRAZIL
COLOMBO	CITY.BRAZIL
MACAÉ	CITY.BRAZIL
PEMATANG SIANTAR	CITY.INDONESIA
BATON ROUGE	CITY.USA
DERBY	CITY.UNITED KINGDOM
ARAPIRACA	CITY.BRAZIL
SATNA	CITY.INDIA
SOSNOWIEC	CITY.POLAND
IRVING	CITY.USA
DIVINÓPOLIS	CITY.BRAZIL
SÃO JOSÉ	CITY.BRAZIL
SUPHAN BURI	CITY.THAILAND
PLOIEŞTI	CITY.ROMANIA
AARHUS	CITY.DENMARK
VIZIANAGARAM	CITY.INDIA
AL-FASHER	CITY.SUDAN
SAKI	CITY.NIGERIA
RADOM	CITY.POLAND
RUSAIFA	CITY.JORDAN
VITORIA-GASTEIZ	CITY.SPAIN
GONDAR	CITY.ETHIOPIA
LILLE	CITY.FRANCE
MATSUMOTO	CITY.JAPAN
SWANSEA	CITY.UNITED KINGDOM
ITABORAÍ	CITY.BRAZIL
SÃO LEOPOLDO	CITY.BRAZIL
AMERICANA	CITY.BRAZIL
SCOTTSDALE	CITY.USA
NORTH LAS VEGAS	CITY.USA
LALITPUR	CITY.NEPAL
INDAIATUBA	CITY.BRAZIL
PILAR	CITY.ARGENTINA
OKARA	CITY.PAKISTAN
KATIHAR	CITY.INDIA
NAKHON SAWAN	CITY.THAILAND
COTIA	CITY.BRAZIL
HARDWAR	CITY.INDIA
ATSUGI	CITY.JAPAN
SONIPAT	CITY.INDIA
FREMONT	CITY.USA
KREMENTCHUG	CITY.UKRAINE
JACAREÍ	CITY.BRAZIL
DALOA	CITY.CÔTE D'IVOIRE
NICOSIA	CITY.CYPRUS
NAGERCOIL	CITY.INDIA
ARARAQUARA	CITY.BRAZIL
MBOUR	CITY.SENEGAL
BANFIELD	CITY.ARGENTINA
CONCEPCIÓN	CITY.CHILE
AS SEEB	CITY.OMAN
GUAYMALLÉN	CITY.ARGENTINA
YAMATO	CITY.JAPAN
PORTOVIEJO	CITY.ECUADOR
PUERTO PRINCESA	CITY.PHILIPPINES
THANJAVUR	CITY.INDIA
ISPARTA	CITY.TURKEY
AL-DSCHUBAIL	CITY.SAUDI-ARABIA
ATIRAU	CITY.KAZAKHSTAN
AGEO	CITY.JAPAN
SANDAKAN	CITY.MALAYSIA
CIUDAD DE FORMOSA	CITY.ARGENTINA
TAKARAZUKA	CITY.JAPAN
BLAGOVESHCHENSK	CITY.RUSSIA
AMURSKAYA OBLAST	CITY.RUSSIA
KREFELD	CITY.GERMANY
SASKATOON	CITY.CANADA
MURWARA	CITY.INDIA
KATNI	CITY.INDIA
NAJAFABAD	CITY.IRAN
NAIHATI	CITY.INDIA
BADALONA	CITY.SPAIN
SAMBHAL	CITY.INDIA
OLONGAPO	CITY.PHILIPPINES
TACLOBAN	CITY.PHILIPPINES
MANTA	CITY.ECUADOR
PHAYAO	CITY.THAILAND
JIMETA	CITY.NIGERIA
PALANGKARAYA	CITY.INDONESIA
TALCA	CITY.CHILE
PRESIDENTE PRUDENTE	CITY.BRAZIL
ECH	CITY.MEXICO
FREIBURG IM BREISGAU	CITY.GERMANY
ITAPEVI	CITY.BRAZIL
GUANARE	CITY.VENEZUELA
VELIKIY NOVGOROD	CITY.RUSSIA
AMOL	CITY.IRAN
MIRPUR KHAS	CITY.PAKISTAN
MERU	CITY.KENYA
MARACANAÚ	CITY.BRAZIL
JALEEB AL-SHUYKH	CITY.KUWAIT
BABOL	CITY.IRAN
CHŌFU	CITY.JAPAN
TALOQAN	CITY.AFGHANISTAN
VARAMIN	CITY.IRAN
ITABUNA	CITY.BRAZIL
DUMAI	CITY.INDONESIA
BENI SUEF	CITY.EGYPT
KHIMKI	CITY.RUSSIA
NADIAD	CITY.INDIA
ÇORUM	CITY.TURKEY
GANGNEUNG	CITY.REPUBLIC OF KOREA
GUANTÁNAMO	CITY.CUBA
PROBOLINGGO	CITY.INDONESIA
GREATER HOBART	CITY.AUSTRALIA
BOBRUISK	CITY.BELARUS
PUERTO MONTT	CITY.CHILE
ORURO	CITY.BOLIVIA
JOSÉ C. PAZ	CITY.ARGENTINA
YAMUNANAGAR	CITY.INDIA
CHINGOLA	CITY.ZAMBIA
JUAZEIRO	CITY.BRAZIL
ENGLISH BAZAR	CITY.INDIA
BIISK	CITY.RUSSIA
KUCHING	CITY.MALAYSIA
TERNOPOL	CITY.UKRAINE
MERGUI	CITY.MYANMAR
MABALACAT	CITY.PHILIPPINES
TAMPERE	CITY.FINLAND
ÇORLU	CITY.TURKEY
MONCLOVA	CITY.MEXICO
LA PAZ	CITY.MEXICO
SUNGAI PETANI	CITY.MALAYSIA
QENA	CITY.EGYPT
SANTA LUZIA	CITY.BRAZIL
TURMERO	CITY.VENEZUELA
ELURU	CITY.INDIA
BOISE	CITY.USA
RICHMOND	CITY.USA
ŌTA	CITY.JAPAN
BIDA	CITY.NIGERIA
ASHDOD	CITY.ISRAEL
SAN BERNARDINO	CITY.USA
ANTAKYA	CITY.TURKEY
BOMA	CITY.DEMOCRATIC REPUBLIC OF THE CONGO
MUNGER	CITY.INDIA
PYATIGORSK	CITY.RUSSIA
LÜBECK	CITY.GERMANY
ABADAN	CITY.IRAN
NOGALES	CITY.MEXICO
HORTOLÂNDIA	CITY.BRAZIL
KUSTANAI	CITY.KAZAKHSTAN
ENVIGADO	CITY.COLOMBIA
BARISHAL	CITY.BANGLADESH
LANÚS	CITY.ARGENTINA
BIRMINGHAM	CITY.USA
NUKUS	CITY.UZBEKISTAN
SANTA CLARA	CITY.CUBA
PETAH TIQWA	CITY.ISRAEL
KYZYLORDA	CITY.KAZAKHSTAN
BRĂILA	CITY.ROMANIA
ENGELS	CITY.RUSSIA
KAMPHAENG PHET	CITY.THAILAND
RONDONÓPOLIS	CITY.BRAZIL
LUTSK	CITY.UKRAINE
PUCALLPA	CITY.PERU
CAJAMARCA	CITY.PERU
HIGÜEY	CITY.DOMINICAN REPUBLIC
CORO	CITY.VENEZUELA
TRIESTE	CITY.ITALY
SPOKANE	CITY.USA
ZINDER	CITY.NIGER
DEHIWALA-MOUNT LAVINIA	CITY.SRI LANKA
ROCHESTER	CITY.USA
DOURADOS	CITY.BRAZIL
PANCHKULA	CITY.INDIA
SIDI BEL ABBÈS	CITY.ALGERIA
KIELCE	CITY.POLAND
ARMAVIR	CITY.RUSSIA
PHAN THIẾT	CITY.VIETNAM
GUATIRE	CITY.VENEZUELA
EINDHOVEN	CITY.NETHERLANDS
OBERHAUSEN	CITY.GERMANY
CAPIATÁ	CITY.PARAGUAY
POTISKUM	CITY.NIGERIA
DESAMPARADOS	CITY.COSTA RICA
TORUŃ	CITY.POLAND
CHUNGJU	CITY.REPUBLIC OF KOREA
PUERTO CABELLO	CITY.VENEZUELA
DES MOINES	CITY.USA
RAICHUR	CITY.INDIA
KAMOKE	CITY.PAKISTAN
TSUKUBA	CITY.JAPAN
KIMCHAEK	CITY.DEMOCRATIC PEOPLE'S REPUBLIC OF KOREA
RENNES	CITY.FRANCE
RIO GRANDE	CITY.BRAZIL
BELAYA TSERKOV	CITY.UKRAINE
CACHOEIRO DE ITAPEMIRIM	CITY.BRAZIL
EL TIGRE	CITY.VENEZUELA
KHARAGPUR	CITY.INDIA
NUMAZU	CITY.JAPAN
TULUÁ	CITY.COLOMBIA
JALALABAD	CITY.AFGHANISTAN
PAKDASHT	CITY.IRAN
CHINIOT	CITY.PAKISTAN
CHACHOENGSAO	CITY.THAILAND
JŌETSU	CITY.JAPAN
BUENAVISTA	CITY.MEXICO
KIMBERLEY	CITY.SOUTH AFRICA
PROKOPYEVSK	CITY.RUSSIA
ACARIGUA	CITY.VENEZUELA
ALVORADA	CITY.BRAZIL
TAIPING	CITY.MALAYSIA
HOBART	CITY.AUSTRALIA
CHAI NAT	CITY.THAILAND
LA SERENA	CITY.CHILE
CARORA	CITY.VENEZUELA
CHAIYAPHUM	CITY.THAILAND
DEBRECEN	CITY.HUNGARY
PSKOV	CITY.RUSSIA
AKYAB	CITY.MYANMAR
AJMAN	CITY.UNITED ARAB EMIRATES
LOBURO	CITY.NIGERIA
BIRATNAGAR	CITY.NEPAL
MODESTO	CITY.USA
CÀ MAU	CITY.VIETNAM
ERFURT	CITY.GERMANY
PADUA	CITY.ITALY
KUMAGAYA	CITY.JAPAN
KARSHI	CITY.UZBEKISTAN
CRICIÚMA	CITY.BRAZIL
BISKRA	CITY.ALGERIA
REYKJAVIK	CITY.ICELAND
CABO FRIO	CITY.BRAZIL
ORADEA	CITY.ROMANIA
MỸ THO	CITY.VIETNAM
FAYETTEVILLE	CITY.USA
PANVEL	CITY.INDIA
ICHEON	CITY.REPUBLIC OF KOREA
MAINZ	CITY.GERMANY
ISESAKI	CITY.JAPAN
WELLINGTON	CITY.NEW ZEALAND
BUTEMBO	CITY.DEMOCRATIC REPUBLIC OF THE CONGO
PINGTUNG	CITY.TAIWAN
KUALA TERENGGANU	CITY.MALAYSIA
HẠ LONG	CITY.VIETNAM
PULI KHUMRI	CITY.AFGHANISTAN
TOAMASINA	CITY.MADAGASCAR
TACOMA	CITY.USA
ROSTOCK	CITY.GERMANY
VANTAA	CITY.FINLAND
PUERTO VALLARTA	CITY.MEXICO
NONG BUA LAM PHU	CITY.THAILAND
DEOGHAR	CITY.INDIA
LOBITO	CITY.ANGOLA
OXNARD	CITY.USA
FONTANA	CITY.USA
OVIEDO	CITY.SPAIN
ONGOLE	CITY.INDIA
COLUMBUS	CITY.USA
ADIYAMAN	CITY.TURKEY
AL-JINAINA	CITY.SUDAN
TAPACHULA	CITY.MEXICO
ABERDEEN	CITY.UNITED KINGDOM
KABWE	CITY.ZAMBIA
BAYAMÓN	CITY.PUERTO RICO
RIO VERDE	CITY.BRAZIL
TARANTO	CITY.ITALY
FALLOUJAH	CITY.IRAQ
CHAPECÓ	CITY.BRAZIL
IWO	CITY.NIGERIA
GUSAU	CITY.NIGERIA
ABHA	CITY.SAUDI-ARABIA
CIUDAD DE NEUQUÉN	CITY.ARGENTINA
ITAJAÍ	CITY.BRAZIL
PHITSANULOK	CITY.THAILAND
CHARLEROI	CITY.BELGIUM
MONTGOMERY	CITY.USA
GLIWICE	CITY.POLAND
İSKENDERUN	CITY.TURKEY
MORENO VALLEY	CITY.USA
KUITO	CITY.ANGOLA
AL-CHARDSCH	CITY.SAUDI-ARABIA
KHOY	CITY.IRAN
YAMOUSSOUKRO	CITY.CÔTE D'IVOIRE
TALISAY	CITY.PHILIPPINES
NANDYAL	CITY.INDIA
SABADELL	CITY.SPAIN
KISHIWADA	CITY.JAPAN
JAYAPURA	CITY.INDONESIA
MORENA	CITY.INDIA
SAVEH	CITY.IRAN
SHREVEPORT	CITY.USA
TOTTORI	CITY.JAPAN
BURGAS	CITY.BULGARIA
PODOLSK	CITY.RUSSIA
AURORA	CITY.USA
YANGJU	CITY.REPUBLIC OF KOREA
TERRASSA	CITY.SPAIN
BOJNURD	CITY.IRAN
YONKERS	CITY.USA
SOBRAL	CITY.BRAZIL
MARADI	CITY.NIGER
BANJARBARU	CITY.INDONESIA
KŌFU	CITY.JAPAN
COQUIMBO	CITY.CHILE
BYTOM	CITY.POLAND
MEYCAUAYAN	CITY.PHILIPPINES
SIBU	CITY.MALAYSIA
ODAWARA	CITY.JAPAN
OSMANIYE	CITY.TURKEY
MÓSTOLES	CITY.SPAIN
PAMPLONA	CITY.SPAIN
KAOLACK	CITY.SENEGAL
RIO CLARO	CITY.BRAZIL
CABO DE SANTO AGOSTINHO	CITY.BRAZIL
BAHIR DAR	CITY.ETHIOPIA
AKRON	CITY.USA
SULLANA	CITY.PERU
SADIQABAD	CITY.PAKISTAN
BHIWANI	CITY.INDIA
HUNTINGTON BEACH	CITY.USA
THANH HÓA	CITY.VIETNAM
KOKAND	CITY.UZBEKISTAN
TOCUYITO	CITY.VENEZUELA
SUZUKA	CITY.JAPAN
ABOMEY	CITY.BENIN
KRAMATORSK	CITY.UKRAINE
PORBANDAR	CITY.INDIA
PALAKKAD	CITY.INDIA
RYBINSK	CITY.RUSSIA
LITTLE ROCK	CITY.USA
ANAND	CITY.INDIA
AUGUSTA	CITY.USA
DODOMA	CITY.TANZANIA
CIUDAD MADERO	CITY.MEXICO
PURNIA	CITY.INDIA
SUBANG JAYA	CITY.MALAYSIA
RASON	CITY.DEMOCRATIC PEOPLE'S REPUBLIC OF KOREA
BALAKOVO	CITY.RUSSIA
BE'ER SHEVA	CITY.ISRAEL
KUTAISI	CITY.GEORGIA
LOUM	CITY.CAMEROON
PARAKOU	CITY.BENIN
KUSONG	CITY.DEMOCRATIC PEOPLE'S REPUBLIC OF KOREA
AMARILLO	CITY.USA
OBUASI	CITY.GHANA
GENEVA	CITY.SWITZERLAND
QAEM SHAHR	CITY.IRAN
GLENDALE	CITY.USA
MATSUE	CITY.JAPAN
HITACHI	CITY.JAPAN
HEBRON	CITY.PALESTINE
MYINGYAN	CITY.MYANMAR
PASSO FUNDO	CITY.BRAZIL
BAHARAMPUR	CITY.INDIA
SAN-PEDRO	CITY.CÔTE D'IVOIRE
BUSHEHR	CITY.IRAN
YUZHNO-SAKHALINSK	CITY.RUSSIA
DOSQUEBRADAS	CITY.COLOMBIA
DUDLEY	CITY.UNITED KINGDOM
MOBILE	CITY.USA
OSAN	CITY.REPUBLIC OF KOREA
GURI	CITY.REPUBLIC OF KOREA
MONYWA	CITY.MYANMAR
ITAMI	CITY.JAPAN
TÉBESSA	CITY.ALGERIA
TARIJA	CITY.BOLIVIA
PETROPAVLOVSK	CITY.KAZAKHSTAN
KASSEL	CITY.GERMANY
GUACARA	CITY.VENEZUELA
AL KHOR	CITY.QATAR
SOHAG	CITY.EGYPT
MUTARE	CITY.ZIMBABWE
DILI	CITY.TIMOR-LESTE
TARAKAN	CITY.INDONESIA
NISHITŌKYŌ	CITY.JAPAN
ALMERE	CITY.NETHERLANDS
TALL AFAR	CITY.IRAQ
ZABRZE	CITY.POLAND
GRONINGEN	CITY.NETHERLANDS
KIRIKKALE	CITY.TURKEY
REGINA	CITY.CANADA
HYESAN	CITY.DEMOCRATIC PEOPLE'S REPUBLIC OF KOREA
GRAND RAPIDS	CITY.USA
YAMAGUCHI	CITY.JAPAN
AL-TUQBA	CITY.SAUDI-ARABIA
BARRANCABERMEJA	CITY.COLOMBIA
ARAÇATUBA	CITY.BRAZIL
GEORGETOWN	CITY.MALAYSIA
QARCHAK	CITY.IRAN
UJI	CITY.JAPAN
SAN ANDRES DE TUMACO	CITY.COLOMBIA
ORMOC	CITY.PHILIPPINES
SALT LAKE CITY	CITY.USA
LUZIÂNIA	CITY.BRAZIL
NETANYA	CITY.ISRAEL
SEVERODVINSK	CITY.RUSSIA
SHAH ALAM	CITY.MALAYSIA
BATU	CITY.INDONESIA
ALTAY	CITY.CHINA
YENAGOA	CITY.NIGERIA
NEWCASTLE UPON TYNE	CITY.UNITED KINGDOM
CHONGJU	CITY.DEMOCRATIC PEOPLE'S REPUBLIC OF KOREA
HURGHADA	CITY.EGYPT
USSURIISK	CITY.RUSSIA
NORTHAMPTON	CITY.UNITED KINGDOM
SAN PABLO DE LAS SALINAS	CITY.MEXICO
SANTA BÁRBARA D'OESTE	CITY.BRAZIL
MUENE-DITU	CITY.DEMOCRATIC REPUBLIC OF THE CONGO
BUREWALA	CITY.PAKISTAN
LINZ	CITY.AUSTRIA
BẠC LIÊU	CITY.VIETNAM
YANBU’ AL-BAHR	CITY.SAUDI-ARABIA
AYDIN	CITY.TURKEY
SELEYANG BARU	CITY.MALAYSIA
MORVI	CITY.INDIA
LAURO DE FREITAS	CITY.BRAZIL
CARTAGENA	CITY.SPAIN
HIGASHIHIROSHIMA	CITY.JAPAN
BRESCIA	CITY.ITALY
KLAIPĖDA	CITY.LITHUANIA
HẢI DƯƠNG	CITY.VIETNAM
CHILPANCINGO	CITY.MEXICO
ORAI	CITY.INDIA
MARAWI	CITY.PHILIPPINES
JESSORE	CITY.BANGLADESH
JEREZ DE LA FRONTERA	CITY.SPAIN
PORTSMOUTH	CITY.UNITED KINGDOM
CASTANHAL	CITY.BRAZIL
PAGADIAN	CITY.PHILIPPINES
EL OUED	CITY.ALGERIA
SINGKAWANG	CITY.INDONESIA
KOROLEV	CITY.RUSSIA
MOSKOVSKAYA OBLAST	CITY.RUSSIA
TALLAHASSEE	CITY.USA
PASURUAN	CITY.INDONESIA
HUNTSVILLE	CITY.USA
BAHRAICH	CITY.INDIA
THÁI BÌNH	CITY.VIETNAM
HAGEN	CITY.GERMANY
PODGORICA	CITY.MONTENEGRO
SIKAR	CITY.INDIA
SAN FRANCISCO DE MACORIS	CITY.DOMINICAN REPUBLIC
VELLORE	CITY.INDIA
HIROSAKI	CITY.JAPAN
KODAIRA	CITY.JAPAN
TERNATE	CITY.INDONESIA
SIRJAN	CITY.IRAN
LIÈGE	CITY.BELGIUM
LUTON	CITY.UNITED KINGDOM
POZA RICA	CITY.MEXICO
MYTISHCHI	CITY.RUSSIA
SINGRAULI	CITY.INDIA
ANGRA DOS REIS	CITY.BRAZIL
PRESTON	CITY.UNITED KINGDOM
SANTANDER	CITY.SPAIN
YACHIYO	CITY.JAPAN
MILTON KEYNES	CITY.UNITED KINGDOM
HOLON	CITY.ISRAEL
NOVA FRIBURGO	CITY.BRAZIL
KHAMMAM	CITY.INDIA
KOTA SORONG	CITY.INDONESIA
MAHESANA	CITY.INDIA
SILCHAR	CITY.INDIA
UGHELLI	CITY.NIGERIA
6TH OF OCTOBER CITY	CITY.EGYPT
LIMASSOL	CITY.CYPRUS
KABINDA	CITY.DEMOCRATIC REPUBLIC OF THE CONGO
SAMBALPUR	CITY.INDIA
GRAND PRAIRIE	CITY.USA
PARAUAPEBAS	CITY.BRAZIL
REWA	CITY.INDIA
KNOXVILLE	CITY.USA
SAINT-LOUIS	CITY.SENEGAL
FERGANA	CITY.UZBEKISTAN
SKIKDA	CITY.ALGERIA
PORTMORE	CITY.JAMAICA
MOCA	CITY.DOMINICAN REPUBLIC
GODOY CRUZ	CITY.ARGENTINA
LAS HERAS	CITY.ARGENTINA
WORCESTER	CITY.USA
FERRAZ DE VASCONCELOS	CITY.BRAZIL
ÁGUAS LINDAS DE GOIÁS	CITY.BRAZIL
ILHÉUS	CITY.BRAZIL
KUSHIRO	CITY.JAPAN
LEGAZPI	CITY.PHILIPPINES
NEWPORT NEWS	CITY.USA
IQUIQUE	CITY.CHILE
BROWNSVILLE	CITY.USA
DONOSTIA	CITY.SPAIN
VALENCIA	CITY.PHILIPPINES
TUNJA	CITY.COLOMBIA
OVERLAND PARK	CITY.USA
TILBURG	CITY.NETHERLANDS
MISKOLC	CITY.HUNGARY
ANSEONG	CITY.REPUBLIC OF KOREA
MITAKA	CITY.JAPAN
PETROPAVLOVSK-KAMCHATSKY	CITY.RUSSIA
LOJA	CITY.ECUADOR
MUKDAHAN	CITY.THAILAND
SHIBIN EL KOM	CITY.EGYPT
UŞAK	CITY.TURKEY
REGGIO CALABRIA	CITY.ITALY
ANTSIRABE	CITY.MADAGASCAR
WAW	CITY.SUDAN
REIMS	CITY.FRANCE
AMADORA	CITY.PORTUGAL
KITALE	CITY.KENYA
SANTA TERESA DEL TUY	CITY.VENEZUELA
FUENLABRADA	CITY.SPAIN
BARRA MANSA	CITY.BRAZIL
GEELONG	CITY.AUSTRALIA
ALCALÁ DE HENARES	CITY.SPAIN
SANTA CLARITA	CITY.USA
TAUNGGYI	CITY.MYANMAR
HINO	CITY.JAPAN
IZUMI	CITY.JAPAN
KRAGUJEVAC	CITY.SERBIA
TAKAOKA	CITY.JAPAN
TIARET	CITY.ALGERIA
LYUBERTSY	CITY.RUSSIA
TURKU	CITY.FINLAND
AMBATO	CITY.ECUADOR
VILA NOVA DE GAIA	CITY.PORTUGAL
SAN FERNANDO DE APURE	CITY.VENEZUELA
NORILSK	CITY.RUSSIA
SYZRAN	CITY.RUSSIA
SPLIT	CITY.CROATIA
PADANG SIDEMPUAN	CITY.INDONESIA
TRONDHEIM	CITY.NORWAY
BIRJAND	CITY.IRAN
DUTSE	CITY.NIGERIA
PROVIDENCE	CITY.USA
BOTSHABELO	CITY.SOUTH AFRICA
TUY HÒA	CITY.VIETNAM
ĀWASSA	CITY.ETHIOPIA
UNNAO	CITY.INDIA
BANÍ	CITY.DOMINICAN REPUBLIC
MORATUWA	CITY.SRI LANKA
BIELSKO-BIAŁA	CITY.POLAND
HUGLI-CHINSURAH	CITY.INDIA
SAARBRÜCKEN	CITY.GERMANY
BENGUELA	CITY.ANGOLA
BACĂU	CITY.ROMANIA
PRACHUAP KHIRI KHAN	CITY.THAILAND
SALMIYA	CITY.KUWAIT
OWO	CITY.NIGERIA
GUARAPUAVA	CITY.BRAZIL
MANAMA	CITY.BAHRAIN
SPLIT	CITY.CROATIA
KUMILLA	CITY.BANGLADESH
MANGAUNG	CITY.SOUTH AFRICA
AKSARAY	CITY.TURKEY
UBE	CITY.JAPAN
VIỆT TRÌ	CITY.VIETNAM
BÉJAÏA	CITY.ALGERIA
HAMM	CITY.GERMANY
ANJŌ	CITY.JAPAN
IKARE	CITY.NIGERIA
PHETCHABURI	CITY.THAILAND
GREGORIO DE LAFERRERE	CITY.ARGENTINA
TACHIKAWA	CITY.JAPAN
MODENA	CITY.ITALY
LE HAVRE	CITY.FRANCE
JACOBABAD	CITY.PAKISTAN
ZLATOUST	CITY.RUSSIA
GARDEN GROVE	CITY.USA
SAN CARLOS	CITY.PHILIPPINES
RAIGANJ	CITY.INDIA
YOLA	CITY.NIGERIA
NOSSA SENHORA DO SOCORRO	CITY.BRAZIL
NAGA	CITY.PHILIPPINES
MIRI	CITY.MALAYSIA
ISIRO	CITY.DEMOCRATIC REPUBLIC OF THE CONGO
KAMENSK-URALSKY	CITY.RUSSIA
LUBUKLINGGAU	CITY.INDONESIA
LEGANÉS	CITY.SPAIN
BANDA ACEH	CITY.INDONESIA
TEMIRTAU	CITY.KAZAKHSTAN
PHUSRO	CITY.INDIA
PANABO	CITY.PHILIPPINES
ADITYAPUR	CITY.INDIA
CARÚPANO	CITY.VENEZUELA
ALAPPUZHA	CITY.INDIA
MURIDIKE	CITY.PAKISTAN
AYACUCHO	CITY.PERU
NORWICH	CITY.UNITED KINGDOM
BASEL	CITY.SWITZERLAND
PILSEN	CITY.CZECH REPUBLIC
SÓC TRĂNG	CITY.VIETNAM
BITUNG	CITY.INDONESIA
TOMAKOMAI	CITY.JAPAN
KORHOGO	CITY.CÔTE D'IVOIRE
KAMAKURA	CITY.JAPAN
TLEMCEN	CITY.ALGERIA
CHATTANOOGA	CITY.USA
OLSZTYN	CITY.POLAND
AFYONKARAHISAR	CITY.TURKEY
GWAGWALADA	CITY.NIGERIA
CHICOLOAPAN DE JUÁREZ	CITY.MEXICO
OCEANSIDE	CITY.USA
CALBAYOG	CITY.PHILIPPINES
CAROLINA	CITY.PUERTO RICO
JACKSON	CITY.USA
IWATA	CITY.JAPAN
PRATO	CITY.ITALY
SÃO JOSÉ DE RIBAMAR	CITY.BRAZIL
FORT LAUDERDALE	CITY.USA
MUZAFFARGARH	CITY.PAKISTAN
PHETCHABUN	CITY.THAILAND
ILAM	CITY.IRAN
SAINT-PAUL	CITY.RÉUNION
CASTELLON DE LA PLANA	CITY.SPAIN
SANTA ROSA	CITY.USA
IBIRITÉ	CITY.BRAZIL
CHINCHA ALTA	CITY.PERU
LA VICTORIA	CITY.VENEZUELA
TOWNSVILLE	CITY.AUSTRALIA
POINTE-À-PITRE	CITY.GUADELOUPE
TERESÓPOLIS	CITY.BRAZIL
SAKURA	CITY.JAPAN
RANCHO CUCAMONGA	CITY.USA
ALEXANDRA	CITY.SOUTH AFRICA
LAMBARÉ	CITY.PARAGUAY
SAINT-ÉTIENNE	CITY.FRANCE
CHARIKAR	CITY.AFGHANISTAN
NOVOCHERKASSK	CITY.RUSSIA
CHIMOIO	CITY.MOZAMBIQUE
PORT ST. LUCIE	CITY.USA
WALSALL	CITY.UNITED KINGDOM
IMABARI	CITY.JAPAN
MADIUN	CITY.INDONESIA
DAWEI	CITY.MYANMAR
GIRÓN	CITY.COLOMBIA
HUÁNUCO	CITY.PERU
PIRAEUS	CITY.GREECE
BUKAND	CITY.IRAN
BRAGA	CITY.PORTUGAL
MESQUITA	CITY.BRAZIL
BAHADURGARH	CITY.INDIA
SALATIGA	CITY.INDONESIA
ODENSE	CITY.DENMARK
BARANOVICHI	CITY.BELARUS
VOLGODONSK	CITY.RUSSIA
MACHILIPATNAM	CITY.INDIA
OUARGLA	CITY.ALGERIA
MATSUSAKA	CITY.JAPAN
KUMBO	CITY.CAMEROON
CIUDAD DEL CARMEN	CITY.MEXICO
MIYAKONOJŌ	CITY.JAPAN
RAE BARELI	CITY.INDIA
HADANO	CITY.JAPAN
JALPAIGURI	CITY.INDIA
EL-AAIÚN	CITY.WESTERN SAHARA
KHAN YUNIS	CITY.PALESTINE
BHARUCH	CITY.INDIA
CHALCO DE DÍAZ COVARRUBIAS	CITY.MEXICO
ABAKAN	CITY.RUSSIA
EDÉA	CITY.CAMEROON
PATHANKOT	CITY.INDIA
HOSHIARPUR	CITY.INDIA
TEMPE	CITY.USA
OBIHIRO	CITY.JAPAN
HUICHON	CITY.DEMOCRATIC PEOPLE'S REPUBLIC OF KOREA
ANDONG	CITY.REPUBLIC OF KOREA
BARAMULA	CITY.INDIA
BURGOS	CITY.SPAIN
KIGOMA	CITY.TANZANIA
TANJUNG PINANG	CITY.INDONESIA
APARTADÓ	CITY.COLOMBIA
SAMARRA	CITY.IRAQ
KABANKALAN	CITY.PHILIPPINES
BERAZATEGUI	CITY.ARGENTINA
BOURNEMOUTH	CITY.UNITED KINGDOM
ONTARIO	CITY.USA
BO	CITY.SIERRA LEONE
İNEGÖL	CITY.TURKEY
VANCOUVER	CITY.USA
MAIKOP	CITY.RUSSIA
ARAGUAÍNA	CITY.BRAZIL
PITEŞTI	CITY.ROMANIA
SUKHOTHAI	CITY.THAILAND
MÜLHEIM AN DER RUHR	CITY.GERMANY
BARRIE	CITY.CANADA
FRANCISCO MORATO	CITY.BRAZIL
NIJMEGEN	CITY.NETHERLANDS
JHELAM	CITY.PAKISTAN
TÂN AN	CITY.VIETNAM
ADONI	CITY.INDIA
FLORENCIA	CITY.COLOMBIA
BENE BERAQ	CITY.ISRAEL
JIND	CITY.INDIA
MIASS	CITY.RUSSIA
CABUDARE	CITY.VENEZUELA
ARAD	CITY.ROMANIA
GUECKEDOU	CITY.GUINEA
CAPE CORAL	CITY.USA
AL-CHUBAR	CITY.SAUDI-ARABIA
ITU	CITY.BRAZIL
CIANJUR	CITY.INDONESIA
TONK	CITY.INDIA
ST. JOHN'S	CITY.CANADA
ITAPECERICA DA SERRA	CITY.BRAZIL
BÉCHAR	CITY.ALGERIA
FIANARANTSOA	CITY.MADAGASCAR
GONZÁLEZ CATÁN	CITY.ARGENTINA
DINAJPUR	CITY.BANGLADESH
QUILPUÉ	CITY.CHILE
ZHUBEI	CITY.TAIWAN
TALA/KANGUNDO	CITY.KENYA
PATRAS	CITY.GREECE
SIOUX FALLS	CITY.USA
TENALI	CITY.INDIA
TOULON	CITY.FRANCE
KANCHEEPURAM	CITY.INDIA
GERMISTON	CITY.SOUTH AFRICA
CAGLIARI	CITY.ITALY
COPIAPÓ	CITY.CHILE
LOEI	CITY.THAILAND
SPRINGFIELD	CITY.USA
IKERRE	CITY.NIGERIA
SAMAWA	CITY.IRAQ
ISHINOMAKI	CITY.JAPAN
SAN CARLOS	CITY.COSTA RICA
DAGUPAN	CITY.PHILIPPINES
VAPI	CITY.INDIA
LAS TUNAS	CITY.CUBA
PARMA	CITY.ITALY
ZIGUINCHOR	CITY.SENEGAL
TIMON	CITY.BRAZIL
SPRINGS	CITY.SOUTH AFRICA
KINDU	CITY.DEMOCRATIC REPUBLIC OF THE CONGO
APOPA	CITY.EL SALVADOR
DESĒ	CITY.ETHIOPIA
ŌGAKI	CITY.JAPAN
BAGO	CITY.PHILIPPINES
PHAN RANG-THÁP CHÀM	CITY.VIETNAM
GÜIGÜE	CITY.VENEZUELA
MUFULIRA	CITY.ZAMBIA
MOSTAGANEM	CITY.ALGERIA
MALANJE	CITY.ANGOLA
CHILLÁN	CITY.CHILE
FERNANDO DE LA MORA	CITY.PARAGUAY
PEORIA	CITY.USA
SZEGED	CITY.HUNGARY
JIUTEPEC	CITY.MEXICO
POÇOS DE CALDAS	CITY.BRAZIL
URIBIA	CITY.COLOMBIA
PEMBROKE PINES	CITY.USA
OYAMA	CITY.JAPAN
MARAQEH	CITY.IRAN
MAYMYO	CITY.MYANMAR
UEDA	CITY.JAPAN
ESMERALDAS	CITY.ECUADOR
SHEBERGHAN	CITY.AFGHANISTAN
SEOSAN	CITY.REPUBLIC OF KOREA
TOYOKAWA	CITY.JAPAN
LUDWIGSHAFEN AM RHEIN	CITY.GERMANY
KUMBA	CITY.CAMEROON
POTSDAM	CITY.GERMANY
VILLA DE CURA	CITY.VENEZUELA
BANHA	CITY.EGYPT
JEQUIÉ	CITY.BRAZIL
ELK GROVE	CITY.USA
NAWABGANJ	CITY.BANGLADESH
LEVERKUSEN	CITY.GERMANY
LINHARES	CITY.BRAZIL
SIRSA	CITY.INDIA
SALEM	CITY.USA
SI SA KET	CITY.THAILAND
PONCE	CITY.PUERTO RICO
CAXIAS	CITY.BRAZIL
SOUTHEND ON SEA	CITY.UNITED KINGDOM
SALAMANCA	CITY.MEXICO
SHIKARPUR	CITY.PAKISTAN
JARAGUÁ DO SUL	CITY.BRAZIL
NAVSARI	CITY.INDIA
RUMBEK	CITY.SUDAN
MALAYER	CITY.IRAN
SHAHR-E-KORD	CITY.IRAN
NARASHINO	CITY.JAPAN
ARICA	CITY.CHILE
NAKHODKA	CITY.RUSSIA
CALABOZO	CITY.VENEZUELA
OLDENBURG	CITY.GERMANY
LANCASTER	CITY.USA
CORONA	CITY.USA
URAYASU	CITY.JAPAN
EUGENE	CITY.USA
SAPELE	CITY.NIGERIA
RZESZÓW	CITY.POLAND
PINDAMONHANGABA	CITY.BRAZIL
BRAGANÇA PAULISTA	CITY.BRAZIL
LAGES	CITY.BRAZIL
BORDJ BOU ARRÉRIDJ	CITY.ALGERIA
PÉCS	CITY.HUNGARY
QUEVEDO	CITY.ECUADOR
NILÓPOLIS	CITY.BRAZIL
KORONADAL	CITY.PHILIPPINES
NACALA	CITY.MOZAMBIQUE
HENZADA	CITY.MYANMAR
SAN LUIS RÍO COLORADO	CITY.MEXICO
SAN CRISTÓBAL DE LAS CASAS	CITY.MEXICO
MAHBUBNAGAR	CITY.INDIA
PURI	CITY.INDIA
ASHIKAGA	CITY.JAPAN
POCHEON	CITY.REPUBLIC OF KOREA
GHAZNI	CITY.AFGHANISTAN
BOGRA	CITY.BANGLADESH
SAN MIGUEL	CITY.ARGENTINA
NASIM SHAHR	CITY.IRAN
KAWANISHI	CITY.JAPAN
ARAURE	CITY.VENEZUELA
BAYAMO	CITY.CUBA
KHANEWAL	CITY.PAKISTAN
SÃO CAETANO DO SUL	CITY.BRAZIL
PALMDALE	CITY.USA
ROBERTSON PET	CITY.INDIA
TOLEDO	CITY.PHILIPPINES
CIUDAD DE RÍO CUARTO	CITY.ARGENTINA
HAFIZABAD	CITY.PAKISTAN
ERODE	CITY.INDIA
ANAPA	CITY.RUSSIA
MELITOPOL	CITY.UKRAINE
RIOBAMBA	CITY.ECUADOR
NAGAREYAMA	CITY.JAPAN
SAYAMA	CITY.JAPAN
SALALAH	CITY.OMAN
BATALA	CITY.INDIA
GETAFE	CITY.SPAIN
OSNABRÜCK	CITY.GERMANY
LIVORNO	CITY.ITALY
ROXAS	CITY.PHILIPPINES
ELEKTROSTAL	CITY.RUSSIA
PUERTO PLATA	CITY.DOMINICAN REPUBLIC
PHRAE	CITY.THAILAND
HALDWANI-CUM-KATHGODAM	CITY.INDIA
LUANSHYA	CITY.ZAMBIA
LEÓN	CITY.NICARAGUA
SALAMANCA	CITY.SPAIN
ISEYIN	CITY.NIGERIA
VIDISHA	CITY.INDIA
NIIZA	CITY.JAPAN
THATON	CITY.MYANMAR
SOLINGEN	CITY.GERMANY
SACABA	CITY.BOLIVIA
SALINAS	CITY.USA
TEIXEIRA DE FREITAS	CITY.BRAZIL
GRENOBLE	CITY.FRANCE
LIJIANG	CITY.CHINA
BAKOUBA	CITY.IRAQ
ALOR SETAR	CITY.MALAYSIA
ITAPETININGA	CITY.BRAZIL
SWINDON	CITY.UNITED KINGDOM
HITACHINAKA	CITY.JAPAN
KINDIA	CITY.GUINEA
FOGGIA	CITY.ITALY
SAHARSA	CITY.INDIA
SALAVAT	CITY.RUSSIA
KOHAT	CITY.PAKISTAN
SORSOGON CITY	CITY.PHILIPPINES
CHLEF	CITY.ALGERIA
THANESAR	CITY.INDIA
KOUTIALA	CITY.MALI
POTOSÍ	CITY.BOLIVIA
PYAY	CITY.MYANMAR
SONGEA	CITY.TANZANIA
SIBIU	CITY.ROMANIA
HERNE	CITY.GERMANY
CUAUTLA	CITY.MEXICO
AKTAU	CITY.KAZAKHSTAN
PALHOÇA	CITY.BRAZIL
FUNTUA	CITY.NIGERIA
PAKOKKU	CITY.MYANMAR
BEREZNIKI	CITY.RUSSIA
BANDAR-E-MAHSHAHR	CITY.IRAN
CHITTOOR	CITY.INDIA
MAHA SARAKHAM	CITY.THAILAND
SPRINGFIELD	CITY.USA
VERAVAL	CITY.INDIA
SEMNAN	CITY.IRAN
ALAGOINHAS	CITY.BRAZIL
HOERYONG	CITY.DEMOCRATIC PEOPLE'S REPUBLIC OF KOREA
MUTRAH	CITY.OMAN
SOUK AHRAS	CITY.ALGERIA
NODA	CITY.JAPAN
BẢO LỘC	CITY.VIETNAM
SANTA BÁRBARA DEL ZULIA	CITY.VENEZUELA
CIUDAD DE SAN LUIS	CITY.ARGENTINA
BẮC NINH	CITY.VIETNAM
SEOGWIPO	CITY.REPUBLIC OF KOREA
SURIN	CITY.THAILAND
MALAYBALAY	CITY.PHILIPPINES
GORONTALO	CITY.INDONESIA
LHOKSEUMAWE	CITY.INDONESIA
CAMARAGIBE	CITY.BRAZIL
MAHAJANGA	CITY.MADAGASCAR
SINPO	CITY.DEMOCRATIC PEOPLE'S REPUBLIC OF KOREA
PASADENA	CITY.USA
JABALYA	CITY.PALESTINE
LA ROMANA	CITY.DOMINICAN REPUBLIC
TANAUAN	CITY.PHILIPPINES
TANJUNG BALAI	CITY.INDONESIA
NEUSS	CITY.GERMANY
TABORA	CITY.TANZANIA
CALDERON	CITY.ECUADOR
CARAPUNGO	CITY.ECUADOR
QUETZALTENANGO	CITY.GUATEMALA
BARREIRAS	CITY.BRAZIL
HEIDELBERG	CITY.GERMANY
FORT COLLINS	CITY.USA
LAKHIMPUR	CITY.INDIA
SITAPUR	CITY.INDIA
CIUDAD BENITO JUÁREZ	CITY.MEXICO
HINDUPUR	CITY.INDIA
KAFR EL-SHEIKH	CITY.EGYPT
SANTIPUR	CITY.INDIA
HAYWARD	CITY.USA
CADIZ	CITY.PHILIPPINES
MAICAO	CITY.COLOMBIA
RAFSANJAN	CITY.IRAN
GULU	CITY.UGANDA
POMONA	CITY.USA
SANTA RITA	CITY.VENEZUELA
CHETUMAL	CITY.MEXICO
DIJON	CITY.FRANCE
TURBO	CITY.COLOMBIA
CARY	CITY.USA
UTTARADIT	CITY.THAILAND
DANGJIN	CITY.REPUBLIC OF KOREA
IKIRUN	CITY.NIGERIA
BANJA LUKA	CITY.BOSNIA-HERZEGOVINA
SAR-E POL	CITY.AFGHANISTAN
GWANGYANG	CITY.REPUBLIC OF KOREA
GANJ BASODA	CITY.INDIA
MOGA	CITY.INDIA
BAWSHAR	CITY.OMAN
UIWANG	CITY.REPUBLIC OF KOREA
PRODDATUR	CITY.INDIA
SHŪNAN	CITY.JAPAN
SALZBURG	CITY.AUSTRIA
ROCKFORD	CITY.USA
HAMILTON	CITY.NEW ZEALAND
PIEDRAS NEGRAS	CITY.MEXICO
QUELIMANE	CITY.MOZAMBIQUE
VALPARAÍSO DE GOIÁS	CITY.BRAZIL
SRINAGAR	CITY.INDIA
PLAYA DEL CARMEN	CITY.MEXICO
DIGOS	CITY.PHILIPPINES
ABBOTSFORD	CITY.CANADA
CAO LÃNH	CITY.VIETNAM
PERVOURALSK	CITY.RUSSIA
MEDINIPUR	CITY.INDIA
DARMSTADT	CITY.GERMANY
KHUZDAR	CITY.PAKISTAN
HABRA	CITY.INDIA
MARGILAN	CITY.UZBEKISTAN
ROUSSE	CITY.BULGARIA
LOS GUAYOS	CITY.VENEZUELA
ALCORCON	CITY.SPAIN
OCUMARE DEL TUY	CITY.VENEZUELA
SPANISH TOWN	CITY.JAMAICA
PARANAGUÁ	CITY.BRAZIL
TAMA	CITY.JAPAN
PARNAÍBA	CITY.BRAZIL
MORENO	CITY.ARGENTINA
FOUMBAN	CITY.CAMEROON
YONAGO	CITY.JAPAN
PERUGIA	CITY.ITALY
KOMAKI	CITY.JAPAN
GWERU	CITY.ZIMBABWE
ALEXANDRIA	CITY.USA
ABAETETUBA	CITY.BRAZIL
BONAO	CITY.DOMINICAN REPUBLIC
ESCONDIDO	CITY.USA
NAGUANAGUA	CITY.VENEZUELA
MCKINNEY	CITY.USA
RAMAT GAN	CITY.ISRAEL
KANSAS CITY	CITY.USA
COIMBRA	CITY.PORTUGAL
ALMETIEVSK	CITY.RUSSIA
MEJICANOS	CITY.EL SALVADOR
IRUMA	CITY.JAPAN
HANAM	CITY.REPUBLIC OF KOREA
ONOMICHI	CITY.JAPAN
OSORNO	CITY.CHILE
LẠNG SƠN	CITY.VIETNAM
CHUMPHON	CITY.THAILAND
CARTAGO	CITY.COSTA RICA
RUDA ŚLĄSKA	CITY.POLAND
JOLIET	CITY.USA
BHARATPUR	CITY.NEPAL
RAFAH	CITY.PALESTINE
PATOS DE MINAS	CITY.BRAZIL
ANGERS	CITY.FRANCE
SUNNYVALE	CITY.USA
CALAMA	CITY.CHILE
CHUDSCHAND	CITY.TAJIKISTAN
TORRANCE	CITY.USA
SASARAM	CITY.INDIA
CIENFUEGOS	CITY.CUBA
MAHABAD	CITY.IRAN
BRIDGEPORT	CITY.USA
LAKEWOOD	CITY.USA
HAJIPUR	CITY.INDIA
BHUJ	CITY.INDIA
CONCORDIA	CITY.ARGENTINA
VĨNH LONG	CITY.VIETNAM
LOGROÑO	CITY.SPAIN
HAARLEM	CITY.NETHERLANDS
LASHIO	CITY.MYANMAR
JINJA	CITY.UGANDA
DARICA	CITY.TURKEY
SHIVPURI	CITY.INDIA
IWAKUNI	CITY.JAPAN
TAK	CITY.THAILAND
ARISH	CITY.EGYPT
DADU	CITY.PAKISTAN
HIGASHIMURAYAMA	CITY.JAPAN
KERTCH	CITY.UKRAINE
HOLLYWOOD	CITY.USA
CIUDAD DE LA RIOJA	CITY.ARGENTINA
MORIGUCHI	CITY.JAPAN
HUDDERSFIELD	CITY.UNITED KINGDOM
FUKAYA	CITY.JAPAN
IZUMO	CITY.JAPAN
MOGI GUAÇU	CITY.BRAZIL
RUBTSOVSK	CITY.RUSSIA
KHANPUR	CITY.PAKISTAN
PATERSON	CITY.USA
PANGKAL PINANG	CITY.INDONESIA
KANKAN	CITY.GUINEA
VALERA	CITY.VENEZUELA
BORISOV	CITY.BELARUS
MAN	CITY.CÔTE D'IVOIRE
KOKTSHETAU	CITY.KAZAKHSTAN
EL VIGÍA	CITY.VENEZUELA
NZEREKORE	CITY.GUINEA
MÉDÉA	CITY.ALGERIA
EL EULMA	CITY.ALGERIA
RANAGHAT	CITY.INDIA
AL-DU'AIYN	CITY.SUDAN
AR'AR	CITY.SAUDI-ARABIA
TÂRGU MUREŞ	CITY.ROMANIA
HUELVA	CITY.SPAIN
VILLEURBANNE	CITY.FRANCE
KAKAMIGAHARA	CITY.JAPAN
KARIYA	CITY.JAPAN
AL-DAMAZIN	CITY.SUDAN
MILAGRO	CITY.ECUADOR
SAINT-DENIS	CITY. RÉUNION	CITY.FRANCE
SHIMLA	CITY.INDIA
NAPERVILLE	CITY.USA
KOLOMNA	CITY.RUSSIA
POOLE	CITY.UNITED KINGDOM
TIRUVANNAMALAI	CITY.INDIA
SYRACUSE	CITY.USA
KAITHAL	CITY.INDIA
GONBAD-E-KAVUS	CITY.IRAN
BALTI	CITY.REPUBLIC OF MOLDOVA
BELTSY	CITY.REPUBLIC OF MOLDOVA
KOGA	CITY.JAPAN
MALLAWI	CITY.EGYPT
LOS ANGELES	CITY.CHILE
OULU	CITY.FINLAND
JALINGO	CITY.NIGERIA
TSUCHIURA	CITY.JAPAN
EKIBASTUZ	CITY.KAZAKHSTAN
ODINTSOVO	CITY.RUSSIA
FRANCO DA ROCHA	CITY.BRAZIL
BAJOS DE HAINA	CITY.DOMINICAN REPUBLIC
RAJNANDGAON	CITY.INDIA
10TH OF RAMADAN CITY	CITY.EGYPT
BONTANG	CITY.INDONESIA
PADERBORN	CITY.GERMANY
MESQUITE	CITY.USA
KENEMA	CITY.SIERRA LEONE
GOJRA	CITY.PAKISTAN
DAYTON	CITY.USA
BẾN TRE	CITY.VIETNAM
SHAHINSHAHR	CITY.IRAN
PORTO SEGURO	CITY.BRAZIL
TOUGGOURT	CITY.ALGERIA
NABLUS	CITY.PALESTINE
GODHRA	CITY.INDIA
MARICÁ	CITY.BRAZIL
DUNDEE	CITY.UNITED KINGDOM
CÚA	CITY.VENEZUELA
LESKOVAC	CITY.SERBIA
OXFORD	CITY.UNITED KINGDOM
IKIRE	CITY.NIGERIA
MBOUDA	CITY.CAMEROON
GHARDAÏA	CITY.ALGERIA
SAVANNAH	CITY.USA
DOMODEDOVO	CITY.RUSSIA
QUEIMADOS	CITY.BRAZIL
MIDDLESBROUGH	CITY.UNITED KINGDOM
MOUNDOU	CITY.CHAD
ISAHAYA	CITY.JAPAN
LE MANS	CITY.FRANCE
BIMA	CITY.INDONESIA
SAÏDA	CITY.ALGERIA
HAZARIBAG	CITY.INDIA
PIEDECUESTA	CITY.COLOMBIA
CLARKSVILLE	CITY.USA
BLACKPOOL	CITY.UNITED KINGDOM
BHIMAVARAM	CITY.INDIA
NÎMES	CITY.FRANCE
CAIRNS	CITY.AUSTRALIA
POUSO ALEGRE	CITY.BRAZIL
KAYES	CITY.MALI
ASABA	CITY.NIGERIA
RYBNIK	CITY.POLAND
NOVOMOSKOVSK	CITY.RUSSIA
TULSKAYA OBLAST	CITY.RUSSIA
REGGIO EMILIA	CITY.ITALY
KELOWNA	CITY.CANADA
SEGOU	CITY.MALI
CHIRCHIK	CITY.UZBEKISTAN
ŌME	CITY.JAPAN
JAÚ	CITY.BRAZIL
NGANDAJIKA	CITY.DEMOCRATIC REPUBLIC OF THE CONGO
ZAMORA	CITY.MEXICO
MANDSAUR	CITY.INDIA
TEKIRDAĞ	CITY.TURKEY
AIX-EN-PROVENCE	CITY.FRANCE
CAGUAS	CITY.PUERTO RICO
JIJIGA	CITY.ETHIOPIA
ORDU	CITY.TURKEY
BREST	CITY.FRANCE
KOPEYSK	CITY.RUSSIA
AL-WAKRAH	CITY.QATAR
TALDYKORGAN	CITY.KAZAKHSTAN
CÓRDOBA	CITY.MEXICO
BILBAIS	CITY.EGYPT
SUBOTICA	CITY.SERBIA
KUWANA	CITY.JAPAN
SAN FERNANDO DEL VALLE DE CATAMARCA	CITY.ARGENTINA
SAGAY	CITY.PHILIPPINES
MACHIQUES	CITY.VENEZUELA
SHERBROOKE	CITY.CANADA
TEÓFILO OTONI	CITY.BRAZIL
SURIGAO CITY	CITY.PHILIPPINES
SHAHRUD	CITY.IRAN
UPPSALA	CITY.SWEDEN
ARNHEM	CITY.NETHERLANDS
PORT LOUIS	CITY.MAURITIUS
HERAKLION	CITY.GREECE
REGENSBURG	CITY.GERMANY
PINAR DEL RÍO	CITY.CUBA
TONGYEONG	CITY.REPUBLIC OF KOREA
NEWPORT	CITY.UNITED KINGDOM
TSURUOKA	CITY.JAPAN
OTURKPO	CITY.NIGERIA
ORANGE	CITY.USA
EL TOCUYO	CITY.VENEZUELA
CLERMONT-FERRAND	CITY.FRANCE
SAN JUAN DE LOS MORROS	CITY.VENEZUELA
RIJEKA	CITY.CROATIA
SAQEZ	CITY.IRAN
PASADENA	CITY.USA
IBARRA	CITY.ECUADOR
DAHUK	CITY.IRAQ
LIVINGSTONE	CITY.ZAMBIA
BOLTON	CITY.UNITED KINGDOM
BAIA MARE	CITY.ROMANIA
LIMOGES	CITY.FRANCE
ANACO	CITY.VENEZUELA
BIRGUNJ	CITY.NEPAL
FULLERTON	CITY.USA
SAN JUAN DEL RÍO	CITY.MEXICO
TUGUEGARAO	CITY.PHILIPPINES
ZHELEZNODOROZHNY	CITY.RUSSIA
EDIRNE	CITY.TURKEY
IPSWICH	CITY.UNITED KINGDOM
VALDIVIA	CITY.CHILE
DIBRUGARH	CITY.INDIA
BREDA	CITY.NETHERLANDS
MARVADSHT	CITY.IRAN
URGENCH	CITY.UZBEKISTAN
KOLAR	CITY.INDIA
MUSASHINO	CITY.JAPAN
STARA ZAGORA	CITY.BULGARIA
TELFORD	CITY.UNITED KINGDOM
SALERNO	CITY.ITALY
NAVOI	CITY.UZBEKISTAN
BANKURA	CITY.INDIA
TARAPOTO	CITY.PERU
BOTUCATU	CITY.BRAZIL
SAN JUAN DE LA MAGUANA	CITY.DOMINICAN REPUBLIC
BRAHMANBARIA	CITY.BANGLADESH
LA CEIBA	CITY.HONDURAS
SAPUCAIA DO SUL	CITY.BRAZIL
NYERI	CITY.KENYA
MANDYA	CITY.INDIA
ZABOL	CITY.IRAN
MARSA MATRUH	CITY.EGYPT
KON TUM	CITY.VIETNAM
YORK	CITY.UNITED KINGDOM
INAZAWA	CITY.JAPAN
PERISTERI	CITY.GREECE
COLIMA	CITY.MEXICO
JECHEON	CITY.REPUBLIC OF KOREA
ŌSAKI	CITY.JAPAN
KILLEEN	CITY.USA
DEHRI-ON-SONE	CITY.INDIA
VILLA ALEMANA	CITY.CHILE
EDE	CITY.NIGERIA
WEST BROMWICH	CITY.UNITED KINGDOM
APELDOORN	CITY.NETHERLANDS
BANDUNDU	CITY.DEMOCRATIC REPUBLIC OF THE CONGO
BADAJOZ	CITY.SPAIN
TAWAU	CITY.MALAYSIA
FRISCO	CITY.USA
HAMPTON	CITY.USA
MCALLEN	CITY.USA
PUNO	CITY.PERU
TOKAT	CITY.TURKEY
BINTULU	CITY.MALAYSIA
MANOKWARI	CITY.INDONESIA
PETERBOROUGH	CITY.UNITED KINGDOM
KOUFA	CITY.IRAQ
CÁDIZ	CITY.SPAIN
KISLOVODSK	CITY.RUSSIA
ISIDRO CASANOVA	CITY.ARGENTINA
KAMINA	CITY.DEMOCRATIC REPUBLIC OF THE CONGO
STOCKPORT	CITY.UNITED KINGDOM
GARANHUNS	CITY.BRAZIL
ATIBAIA	CITY.BRAZIL
COMODORO RIVADAVIA	CITY.ARGENTINA
LEON	CITY.SPAIN
MADANAPALLE	CITY.INDIA
SA KAEO	CITY.THAILAND
QUWAISIMA	CITY.JORDAN
BANGUI/ZONGO	CITY.DEMOCRATIC REPUBLIC OF THE CONGO
GIMCHEON	CITY.REPUBLIC OF KOREA
MALERKOTLA	CITY.INDIA
KARAMAN	CITY.TURKEY
ILAGAN	CITY.PHILIPPINES
KIZILTEPE	CITY.TURKEY
NEFTEKAMSK	CITY.RUSSIA
MANDI BAHAUDDIN	CITY.PAKISTAN
PINSK	CITY.BELARUS
TANGAIL	CITY.BANGLADESH
WARREN	CITY.USA
VITÓRIA DE SANTO ANTÃO	CITY.BRAZIL
TOURS	CITY.FRANCE
PYINMANA	CITY.MYANMAR
RAVENNA	CITY.ITALY
TEBING TINGGI	CITY.INDONESIA
PEREZ ZELEDON	CITY.COSTA RICA
GEORGETOWN	CITY.GUYANA
YATSUSHIRO	CITY.JAPAN
QUẢNG NGÃI	CITY.VIETNAM
LAGHOUAT	CITY.ALGERIA
BUKOBA	CITY.TANZANIA
TANDO ALLAHYAR	CITY.PAKISTAN
SANTA TECLA	CITY.EL SALVADOR
CIUDAD ACUÑA	CITY.MEXICO
SLAVYANSK	CITY.UKRAINE
YENANGYAUNG	CITY.MYANMAR
AFIKPO	CITY.NIGERIA
BELLEVUE	CITY.USA
BARBACENA	CITY.BRAZIL
MATANZAS	CITY.CUBA
SANTA RITA	CITY.BRAZIL
NARATHIWAT	CITY.THAILAND
KHOST	CITY.AFGHANISTAN
LANGSA	CITY.INDONESIA
WEST VALLEY CITY	CITY.USA
ISE	CITY.JAPAN
ABIKO	CITY.JAPAN
SABARÁ	CITY.BRAZIL
AMIENS	CITY.FRANCE
SIRAJGANJ	CITY.BANGLADESH
CAPE COAST	CITY.GHANA
GEMENA	CITY.DEMOCRATIC REPUBLIC OF THE CONGO
COLUMBIA	CITY.USA
MUSOMA	CITY.TANZANIA
TOBRUK	CITY.LIBYA
FORT-DE-FRANCE	CITY.MARTINIQUE
YOPAL	CITY.COLOMBIA
HASAVIURT	CITY.RUSSIA
KADAMRASUL	CITY.BANGLADESH
LALITPUR	CITY.INDIA
MADHABDI	CITY.BANGLADESH
SHAGAMU	CITY.NIGERIA
M'SILA	CITY.ALGERIA
BETTIAH	CITY.INDIA
SANTIAGO	CITY.PHILIPPINES
LAUSANNE	CITY.SWITZERLAND
CHIGUALLANTE	CITY.CHILE
NOBEOKA	CITY.JAPAN
IPIALES	CITY.COLOMBIA
KARA	CITY.TOGO
SETO	CITY.JAPAN
KOFORIDUA	CITY.GHANA
BUZĂU	CITY.ROMANIA
IIZUKA	CITY.JAPAN
BELOVO	CITY.RUSSIA
JYVÄSKYLÄ	CITY.FINLAND
AL-HAWIYYA	CITY.SAUDI-ARABIA
BLITAR	CITY.INDONESIA
GREATER DARWIN	CITY.AUSTRALIA
OLATHE	CITY.USA
TYCHY	CITY.POLAND
RABAK	CITY.SUDAN
CHAGHCHARAN	CITY.AFGHANISTAN
SIMÕES FILHO	CITY.BRAZIL
OZAMIZ	CITY.PHILIPPINES
JIJEL	CITY.ALGERIA
JIZZAKH	CITY.UZBEKISTAN
GÖLCÜK	CITY.TURKEY
TRÀ VINH	CITY.VIETNAM
ARAUCÁRIA	CITY.BRAZIL
PHICHIT	CITY.THAILAND
VARGINHA	CITY.BRAZIL
YENAKIIEVE	CITY.UKRAINE
STERLING HEIGHTS	CITY.USA
SHINYANGA	CITY.TANZANIA
TORBAT-E-HEYDARIYEH	CITY.IRAN
SABHAR	CITY.BANGLADESH
DĄBROWA GÓRNICZA	CITY.POLAND
VALLE DE LA PASCUA	CITY.VENEZUELA
ABBOTTABAD	CITY.PAKISTAN
UROMI	CITY.NIGERIA
FERRARA	CITY.ITALY
ENSCHEDE	CITY.NETHERLANDS
LARISSA	CITY.GREECE
CARTAGO	CITY.COLOMBIA
DASKA	CITY.PAKISTAN
NEW HAVEN	CITY.USA
NINH BÌNH	CITY.VIETNAM
TOLEDO	CITY.BRAZIL
MIRAMAR	CITY.USA
PRAIA	CITY.CABO VERDE
OTARU	CITY.JAPAN
MANZANILLO	CITY.MEXICO
KADOMA	CITY.JAPAN
SAN CARLOS	CITY.PHILIPPINES
GUASDUALITO	CITY.VENEZUELA
SINNAR AL-MADINA	CITY.SUDAN
EPWORTH	CITY.ZIMBABWE
EMBU	CITY.KENYA
GAZIPUR	CITY.BANGLADESH
FUJIEDA	CITY.JAPAN
URUGUAIANA	CITY.BRAZIL
ZARAZA	CITY.VENEZUELA
SANTA LUCÍA	CITY.VENEZUELA
SAN JOSE	CITY.PHILIPPINES
KHORAMSHAHR	CITY.IRAN
AIZUWAKAMATSU	CITY.JAPAN
PAKPATTAN	CITY.PAKISTAN
FUSAGASUGÁ	CITY.COLOMBIA
PALOPO	CITY.INDONESIA
APUCARANA	CITY.BRAZIL
CIUDAD DELGADO	CITY.EL SALVADOR
BAT YAM	CITY.ISRAEL
JI-PARANÁ	CITY.BRAZIL
PRABUMULIH	CITY.INDONESIA
KARATSU	CITY.JAPAN
NAOGAON	CITY.BANGLADESH
CAMETÁ	CITY.BRAZIL
INGOLSTADT	CITY.GERMANY
DÜZCE	CITY.TURKEY
ŠIAULIAI	CITY.LITHUANIA
WACO	CITY.USA
ZACATECAS	CITY.MEXICO
MISATO	CITY.JAPAN
UNAIZA	CITY.SAUDI-ARABIA
BAHAWALNAGAR	CITY.PAKISTAN
BERN	CITY.SWITZERLAND
SONGRIM	CITY.DEMOCRATIC PEOPLE'S REPUBLIC OF KOREA
TANDO ADAM	CITY.PAKISTAN
ANGREN	CITY.UZBEKISTAN
KÖRFEZ	CITY.TURKEY
THOUSAND OAKS	CITY.USA
OPOLE	CITY.POLAND
GAGNOA	CITY.CÔTE D'IVOIRE
CAGUA	CITY.VENEZUELA
POLLACHI	CITY.INDIA
CEDAR RAPIDS	CITY.USA
OKINAWA	CITY.JAPAN
GYŐR	CITY.HUNGARY
STAVANGER	CITY.NORWAY
CAM RANH	CITY.VIETNAM
TÁRIBA	CITY.VENEZUELA
ŌSHŪ	CITY.JAPAN
WAŁBRZYCH	CITY.POLAND
KHANNA	CITY.INDIA
NEEMUCH	CITY.INDIA
CHARLESTON	CITY.USA
HAWALLI	CITY.KUWAIT
PŁOCK	CITY.POLAND
PALWAL	CITY.INDIA
KRUŠEVAC	CITY.SERBIA
KHAIRPUR	CITY.PAKISTAN
VISALIA	CITY.USA
MINOH	CITY.JAPAN
JĪMMA	CITY.ETHIOPIA
ELBLĄG	CITY.POLAND
KIRISHIMA	CITY.JAPAN
TOPEKA	CITY.USA
ARARAS	CITY.BRAZIL
CRATO	CITY.BRAZIL
ZAMA	CITY.JAPAN
METRO	CITY.INDONESIA
ELIZABETH	CITY.USA
DUNEDIN	CITY.NEW ZEALAND
GAINESVILLE	CITY.USA
ŌMUTA	CITY.JAPAN
THORNTON	CITY.USA
BEPPU	CITY.JAPAN
FACATATIVÁ	CITY.COLOMBIA
SIIRT	CITY.TURKEY
YASOTHON	CITY.THAILAND
RIO DAS OSTRAS	CITY.BRAZIL
PALANPUR	CITY.INDIA
NONSAN	CITY.REPUBLIC OF KOREA
ROSEVILLE	CITY.USA
ASAKA	CITY.JAPAN
CHERKESSK	CITY.RUSSIA
NKONGSAMBA	CITY.CAMEROON
SINOP	CITY.BRAZIL
ANDIMESHK	CITY.IRAN
BẮC GIANG	CITY.VIETNAM
SERPUKHOV	CITY.RUSSIA
CARROLLTON	CITY.USA
ITUZAINGÓ	CITY.ARGENTINA
CORAL SPRINGS	CITY.USA
ZUBAIR	CITY.IRAQ
VERACRUZ	CITY. BOCA DEL RÍO MUNICIPALITY	CITY.MEXICO
GUNTAKAL	CITY.INDIA
TROIS-RIVIÈRES	CITY.CANADA
STAMFORD	CITY.USA
SLOUGH	CITY.UNITED KINGDOM
SIMI VALLEY	CITY.USA
MATI	CITY.PHILIPPINES
CUBATÃO	CITY.BRAZIL
KATI	CITY.MALI
EBINA	CITY.JAPAN
MIHTARLAM	CITY.AFGHANISTAN
POCOCI	CITY.COSTA RICA
CONCORD	CITY.USA
DAITŌ	CITY.JAPAN
PINHAIS	CITY.BRAZIL
BATUMI	CITY.GEORGIA
KRASNOGORSK	CITY.RUSSIA
GORZÓW WIELKOPOLSKI	CITY.POLAND
MOGOK	CITY.MYANMAR
NEFTEYUGANSK	CITY.RUSSIA
NABADWIP	CITY.INDIA
URDANETA	CITY.PHILIPPINES
KIDAPAWAN	CITY.PHILIPPINES
SAN NICOLÁS DE LOS ARROYOS	CITY.ARGENTINA
SANTA CRUZ DO SUL	CITY.BRAZIL
UDUPI	CITY.INDIA
JAGDALPUR	CITY.INDIA
NAPIER-HASTINGS	CITY.NEW ZEALAND
MATSUBARA	CITY.JAPAN
CACHOEIRINHA	CITY.BRAZIL
MOTIHARI	CITY.INDIA
CHISHTIAN	CITY.PAKISTAN
TABACO	CITY.PHILIPPINES
HARTFORD	CITY.USA
BWARI	CITY.NIGERIA
KIRYUKIRYŪ	CITY.JAPAN
NARITA	CITY.JAPAN
WÜRZBURG	CITY.GERMANY
KRALJEVO	CITY.SERBIA
KASHIHARA	CITY.JAPAN
MOCUBA	CITY.MOZAMBIQUE
CIUDAD VALLES	CITY.MEXICO
GUADALUPE	CITY.MEXICO
BALNEÁRIO CAMBORIÚ	CITY.BRAZIL
AMERSFOORT	CITY.NETHERLANDS
KENT	CITY.USA
CONSELHEIRO LAFAIETE	CITY.BRAZIL
GONGJU	CITY.REPUBLIC OF KOREA
MARAND	CITY.IRAN
RESENDE	CITY.BRAZIL
KITAMI	CITY.JAPAN
NOVOCHEBOKSARSK	CITY.RUSSIA
LAFAYETTE	CITY.USA
PILIBHIT	CITY.INDIA
CALAPAN	CITY.PHILIPPINES
RUDNI	CITY.KAZAKHSTAN
KRASNYI LUCH	CITY.UKRAINE
MIDLAND	CITY.USA
SUNYANI	CITY.GHANA
SANTANA DE PARNAÍBA	CITY.BRAZIL
DIMAPUR	CITY.INDIA
SHAHREZA	CITY.IRAN
KISARAZU	CITY.JAPAN
NAKHON PHANOM	CITY.THAILAND
TAM KỲ	CITY.VIETNAM
SIRACUSA	CITY.ITALY
HEREDIA	CITY.COSTA RICA
ITAPIPOCA	CITY.BRAZIL
RANONG	CITY.THAILAND
SURPRISE	CITY.USA
JAMALPUR	CITY.BANGLADESH
KUSATSU	CITY.JAPAN
MOHALI	CITY.INDIA
MAGANGUÉ	CITY.COLOMBIA
NIIHAMA	CITY.JAPAN
ILOPANGO	CITY.EL SALVADOR
RELIZANE	CITY.ALGERIA
GLOUCESTER	CITY.UNITED KINGDOM
ICHINOSEKI	CITY.JAPAN
PUNTA ARENAS	CITY.CHILE
DENTON	CITY.USA
MIANDOAB	CITY.IRAN
SANO	CITY.JAPAN
MUBI	CITY.NIGERIA
MUNCHON	CITY.DEMOCRATIC PEOPLE'S REPUBLIC OF KOREA
PANCEVO	CITY.SERBIA
PAYAKUMBUH	CITY.INDONESIA
SAKAKAH	CITY.SAUDI-ARABIA
SÃO MATEUS	CITY.BRAZIL
SAN PEDRO GARZA GARCÍA	CITY.MEXICO
VĨNH YÊN	CITY.VIETNAM
MUROM	CITY.RUSSIA
ZRENJANIN	CITY.SERBIA
RUSTAVI	CITY.GEORGIA
WOLFSBURG	CITY.GERMANY
CAMPO LARGO	CITY.BRAZIL
GUELPH	CITY.CANADA
CAUAYAN	CITY.PHILIPPINES
TOUNGOO	CITY.MYANMAR
SADULPUR	CITY.INDIA
RAJAPALAYAM	CITY.INDIA
SEJONG	CITY.REPUBLIC OF KOREA
BOCA CHICA	CITY.DOMINICAN REPUBLIC
TONDABAYASHI	CITY.JAPAN
BOR	CITY.RUSSIA
UMM QASR	CITY.IRAQ
PABNA	CITY.BANGLADESH
FUJINOMIYA	CITY.JAPAN
JARANWALA	CITY.PAKISTAN
WADI AS-SIR	CITY.JORDAN
EDFU	CITY.EGYPT
MARANGUAPE	CITY.BRAZIL
DHARMAVARAM	CITY.INDIA
GYUMRI	CITY.ARMENIA
LENINAKAN	CITY.ARMENIA
HỘI AN	CITY.VIETNAM
NEGOMBO	CITY.SRI LANKA
COLATINA	CITY.BRAZIL
KASHIPUR	CITY.INDIA
AALBORG	CITY.DENMARK
BAGÉ	CITY.BRAZIL
HƯNG YÊN	CITY.VIETNAM
UHTA	CITY.RUSSIA
NAUCALPAN	CITY.MEXICO
SAN JUAN	CITY.PHILIPPINES
SIVAKASI	CITY.INDIA
PHỦ LÝ	CITY.VIETNAM
OREKHOVO-ZUEVO	CITY.RUSSIA
VICTORVILLE	CITY.USA
PITALITO	CITY.COLOMBIA
DERINCE	CITY.TURKEY
SILAY	CITY.PHILIPPINES
BUTWAL	CITY.NEPAL
WATFORD	CITY.UNITED KINGDOM
ARARUAMA	CITY.BRAZIL
FRESNILLO	CITY.MEXICO
EBETSU	CITY.JAPAN
AMPANG/ULU KELANG	CITY.MALAYSIA
DUMAGUETE	CITY.PHILIPPINES
MARIARA	CITY.VENEZUELA
ORIZABA	CITY.MEXICO
HUARAZ	CITY.PERU
NIKOPOL	CITY.UKRAINE
DIMITROVGRAD	CITY.RUSSIA
METZ	CITY.FRANCE
PRESTON	CITY.UNITED KINGDOM
CHÍA	CITY.COLOMBIA
FLORENCIO VARELA	CITY.ARGENTINA
AGUALVA-CACÉM	CITY.PORTUGAL
EVPATORIYA	CITY.UKRAINE
DIPOLOG	CITY.PHILIPPINES
WŁOCŁAWEK	CITY.POLAND
DARJILING	CITY.INDIA
TALCAHUANO	CITY.CHILE
YAIZU	CITY.JAPAN
EVANSVILLE	CITY.USA
MARITUBA	CITY.BRAZIL
SANTA CLARA	CITY.USA
SEVERODONETSK	CITY.UKRAINE
MONZA	CITY.ITALY
MOJOKERTO	CITY.INDONESIA
BRAGANÇA	CITY.BRAZIL
JEONGEUP	CITY.REPUBLIC OF KOREA
ABILENE	CITY.USA
DSCHANG	CITY.CAMEROON
GUELMA	CITY.ALGERIA
MALAKAL	CITY.SUDAN
ATHENS	CITY.USA
CODÓ	CITY.BRAZIL
DHARAN	CITY.NEPAL
BOLU	CITY.TURKEY
FÜRTH	CITY.GERMANY
KŌNOSU	CITY.JAPAN
YALA	CITY.THAILAND
LYSYCHANSK	CITY.UKRAINE
BRUSQUE	CITY.BRAZIL
DERBENT	CITY.RUSSIA
RIBEIRÃO PIRES	CITY.BRAZIL
AHMADPUR EAST	CITY.PAKISTAN
CORK	CITY.IRELAND
REHOVOT	CITY.ISRAEL
BERDYANSK	CITY.UKRAINE
FAO	CITY.IRAQ
DANAO	CITY.PHILIPPINES
MENEMEN	CITY.TURKEY
ULM	CITY.GERMANY
OFFENBACH AM MAIN	CITY.GERMANY
MARIBOR	CITY.SLOVENIA
SANTA COLOMA DE GRAMENET	CITY.SPAIN
BAU-BAU	CITY.INDONESIA
LATINA	CITY.ITALY
MOPTI	CITY.MALI
SERTÃOZINHO	CITY.BRAZIL
CATANDUVA	CITY.BRAZIL
VALLEJO	CITY.USA
ASHQELON	CITY.ISRAEL
DORDRECHT	CITY.NETHERLANDS
KOKUBUNJI	CITY.JAPAN
MATARÓ	CITY.SPAIN
ZIELONA GÓRA	CITY.POLAND
KAKEGAWA	CITY.JAPAN
KAJANG DAN SUNGAI CHUA	CITY.MALAYSIA
MIT GHAMR	CITY.EGYPT
MIRAMAR	CITY.MEXICO
TODA	CITY.JAPAN
ALLENTOWN	CITY.USA
BARRETOS	CITY.BRAZIL
CHIKKAMAGALURU	CITY.INDIA
IGUALA	CITY.MEXICO
LA CONCEPCIÓN	CITY.VENEZUELA
GUARATINGUETÁ	CITY.BRAZIL
PAULO AFONSO	CITY.BRAZIL
VALINHOS	CITY.BRAZIL
TARNÓW	CITY.POLAND
GUDIVADA	CITY.INDIA
HABIKINO	CITY.JAPAN
ZIPAQUIRÁ	CITY.COLOMBIA
MAGELANG	CITY.INDONESIA
BALESHWAR TOWN	CITY.INDIA
NORMAN	CITY.USA
MANCHERIAL	CITY.INDIA
HOVSGOL	CITY.MONGOLIA
HEILBRONN	CITY.GERMANY
DELICIAS	CITY.MEXICO
LEIDEN	CITY.NETHERLANDS
GUARAPARI	CITY.BRAZIL
AZARE	CITY.NIGERIA
EKPOMA	CITY.NIGERIA
NEVINNOMYSSK	CITY.RUSSIA
HANDA	CITY.JAPAN
INNSBRUCK	CITY.AUSTRIA
GINGOOG	CITY.PHILIPPINES
BEAUMONT	CITY.USA
KINGSTON	CITY.CANADA
PFORZHEIM	CITY.GERMANY
MAGWAY	CITY.MYANMAR
TURGUTLU	CITY.TURKEY
TAURANGA	CITY.NEW ZEALAND
CIUDAD DE VILLA DE ÁLVAREZ	CITY.MEXICO
HÀ TĨNH	CITY.VIETNAM
HIGASHIŌMI	CITY.JAPAN
UPATA	CITY.VENEZUELA
JANDIRA	CITY.BRAZIL
PERPIGNAN	CITY.FRANCE
ITAGUAÍ	CITY.BRAZIL
KAMYSHIN	CITY.RUSSIA
MAASTRICHT	CITY.NETHERLANDS
BRUGES	CITY.BELGIUM
SRIKAKULAM	CITY.INDIA
MALAMBO	CITY.COLOMBIA
ROTHERHAM	CITY.UNITED KINGDOM
INDEPENDENCE	CITY.USA
TARRAGONA	CITY.SPAIN
ADILABAD	CITY.INDIA
BIRIGUI	CITY.BRAZIL
BUKITTINGGI	CITY.INDONESIA
IZEH	CITY.IRAN
MURFREESBORO	CITY.USA
ANN ARBOR	CITY.USA
SPRINGFIELD	CITY.USA
ZOETERMEER	CITY.NETHERLANDS
AHUACHAPAN	CITY.EL SALVADOR
BESANÇON	CITY.FRANCE
ORSHA	CITY.BELARUS
GÖTTINGEN	CITY.GERMANY
BERKELEY	CITY.USA
MANPO	CITY.DEMOCRATIC PEOPLE'S REPUBLIC OF KOREA
ITABIRA	CITY.BRAZIL
YAVATMAL	CITY.INDIA
VOTORANTIM	CITY.BRAZIL
BANDAR-E-ANZALI	CITY.IRAN
LORICA	CITY.COLOMBIA
PORT-GENTIL	CITY.GABON
MALÉ	CITY.MALDIVES
PEORIA	CITY.USA
VESPASIANO	CITY.BRAZIL
TERMEZ	CITY.UZBEKISTAN
BARNALA	CITY.INDIA
HŌFU	CITY.JAPAN
SRI JAYAWARDANAPURA KOTTE	CITY.SRI LANKA
NAGAON	CITY.INDIA
SEVERSK	CITY.RUSSIA
NARASARAOPET	CITY.INDIA
TORBALI	CITY.TURKEY
BANDIRMA	CITY.TURKEY
RIONEGRO	CITY.COLOMBIA
PROVO	CITY.USA
PESCARA	CITY.ITALY
DARWIN	CITY.AUSTRALIA
NYÍREGYHÁZA	CITY.HUNGARY
BOTOŞANI	CITY.ROMANIA
AÏN BÉÏDA	CITY.ALGERIA
BOTTROP	CITY.GERMANY
RAIGARH	CITY.INDIA
VEHARI	CITY.PAKISTAN
MARBELLA	CITY.SPAIN
SERGIEV POSAD	CITY.RUSSIA
EL MONTE	CITY.USA
PAÇO DO LUMIAR	CITY.BRAZIL
NASUSHIOBARA	CITY.JAPAN
ARAGUARI	CITY.BRAZIL
GUDALAJARA DE BUGA	CITY.COLOMBIA
PANEVĖŽYS	CITY.LITHUANIA
SAIDPUR	CITY.BANGLADESH
AGADEZ	CITY.NIGER
KINTANU	CITY.DEMOCRATIC REPUBLIC OF THE CONGO
TATUÍ	CITY.BRAZIL
CHORZÓW	CITY.POLAND
ATBARA	CITY.SUDAN
TRINDADE	CITY.BRAZIL
HIGASHIKURUME	CITY.JAPAN
VÁRZEA PAULISTA	CITY.BRAZIL
IKOMA	CITY.JAPAN
RECKLINGHAUSEN	CITY.GERMANY
KIPUSHI	CITY.DEMOCRATIC REPUBLIC OF THE CONGO
QUIBDO	CITY.COLOMBIA
ŠABAC	CITY.SERBIA
ROORKEE	CITY.INDIA
COLUMBIA	CITY.USA
HATSUKAICHI	CITY.JAPAN
KOGANEI	CITY.JAPAN
GOICOECHEA	CITY.COSTA RICA
CIEGO DE AVILA	CITY.CUBA
LLEIDA	CITY.SPAIN
PUNTARENAS	CITY.COSTA RICA
BATAISK	CITY.RUSSIA
BADAGRY	CITY.NIGERIA
LANGTANG	CITY.NIGERIA
SAKATA	CITY.JAPAN
SAN FERNANDO	CITY.PHILIPPINES
TAJIMI	CITY.JAPAN
KAMALIA	CITY.PAKISTAN
EJIDO	CITY.VENEZUELA
UZHGOROD	CITY.UKRAINE
ČAČAK	CITY.SERBIA
JAMUNDÍ	CITY.COLOMBIA
SACHEON	CITY.REPUBLIC OF KOREA
VALSAD	CITY.INDIA
ESCUINTLA	CITY.GUATEMALA
PAGAR ALAM	CITY.INDONESIA
AMBIKAPUR	CITY.INDIA
KHENCHELA	CITY.ALGERIA
GIRIDIH	CITY.INDIA
YEONGJU	CITY.REPUBLIC OF KOREA
KAWACHINAGANO	CITY.JAPAN
NOVY URENGOY	CITY.RUSSIA
CHANDAUSI	CITY.INDIA
SOGAMOSO	CITY.COLOMBIA
BOULOGNE-BILLANCOURT	CITY.FRANCE
ORLÉANS	CITY.FRANCE
MTWARA	CITY.TANZANIA
JAHROM	CITY.IRAN
URUMA	CITY.JAPAN
BAYAWAN	CITY.PHILIPPINES
CIUDAD CUAUHTÉMOC	CITY.MEXICO
AUCHI	CITY.NIGERIA
TOLIARA	CITY.MADAGASCAR
LANSING	CITY.USA
NAVOJOA	CITY.MEXICO
ARAPONGAS	CITY.BRAZIL
PURULIA	CITY.INDIA
PATAN	CITY.INDIA
SHCHELKOVO	CITY.RUSSIA
FARGO	CITY.USA
SANDA	CITY.JAPAN
CAP-HAITIEN	CITY.HAITI
CAMBRIDGE	CITY.UNITED KINGDOM
SOUTH KHEETAN	CITY.KUWAIT
DURRËS	CITY.ALBANIA
DOWNEY	CITY.USA
TILA AL-ALI	CITY.JORDAN
UÍGE	CITY.ANGOLA
BERGAMO	CITY.ITALY
EL-HAWAMDEYYA	CITY.EGYPT
SALTO	CITY.BRAZIL
ALMALYK	CITY.UZBEKISTAN
GUAYMAS	CITY.MEXICO
BAGAHA	CITY.INDIA
JAÉN	CITY.SPAIN
BARCARENA	CITY.BRAZIL
POÁ	CITY.BRAZIL
SHASHEMENNĒ	CITY.ETHIOPIA
CIUDAD DE SAN JUAN	CITY.ARGENTINA
SATU MARE	CITY.ROMANIA
KYZYL	CITY.RUSSIA
PARE-PARE	CITY.INDONESIA
MUDON	CITY.MYANMAR
SAIJŌ	CITY.JAPAN
PASSOS	CITY.BRAZIL
MISHIMA	CITY.JAPAN
BENTO GONÇALVES	CITY.BRAZIL
ACHALPUR	CITY.INDIA
COSTA MESA	CITY.USA
ARTEM	CITY.RUSSIA
PRIMORSKIY KRAI	CITY.RUSSIA
YACUIBA	CITY.BOLIVIA
SAN FELIPE	CITY.VENEZUELA
OSMANABAD	CITY.INDIA
WILMINGTON	CITY.USA
MINATITLÁN	CITY.MEXICO
EUNÁPOLIS	CITY.BRAZIL
LOMAS DE ZAMORA	CITY.ARGENTINA
DUITAMA	CITY.COLOMBIA
BOUSAADA	CITY.ALGERIA
AKISHIMA	CITY.JAPAN
YUMBO	CITY.COLOMBIA
ARVADA	CITY.USA
TEMPERLEY	CITY.ARGENTINA
TRÊS LAGOAS	CITY.BRAZIL
SÃO FÉLIX DO XINGU	CITY.BRAZIL
SIVEREK	CITY.TURKEY
ITATIBA	CITY.BRAZIL
ALMIRANTE TAMANDARÉ	CITY.BRAZIL
INGLEWOOD	CITY.USA
CARAGUATATUBA	CITY.BRAZIL
TOVAR	CITY.VENEZUELA
MIAMI GARDENS	CITY.USA
REUTLINGEN	CITY.GERMANY
DAUGAVPILS	CITY.LATVIA
DEESA	CITY.INDIA
OKTYABRSKY	CITY.RUSSIA
MYITKYINA	CITY.MYANMAR
NANDURBAR	CITY.INDIA
MONTEGO BAY	CITY.JAMAICA
JIROFT	CITY.IRAN
PAVLOGRAD	CITY.UKRAINE
CIUDAD DE MENDOZA	CITY.ARGENTINA
AZAMGARH	CITY.INDIA
CARLSBAD	CITY.USA
WESTMINSTER	CITY.USA
HIKONE	CITY.JAPAN
ROUEN	CITY.FRANCE
MOZIR	CITY.BELARUS
IGARASSU	CITY.BRAZIL
RÂMNICU VÂLCEA	CITY.ROMANIA
ALCHEVSK	CITY.UKRAINE
VÄSTERÅS	CITY.SWEDEN
TOOWOOMBA	CITY.AUSTRALIA
CHIKUSEI	CITY.JAPAN
ROCHESTER	CITY.USA
ODESSA	CITY.USA
ZWOLLE	CITY.NETHERLANDS
KOBLENZ	CITY.GERMANY
SANTANA	CITY.BRAZIL
HAKUSAN	CITY.JAPAN
MARUGAME	CITY.JAPAN
RAMGARH	CITY.INDIA
MASAYA	CITY.NICARAGUA
MARIVAN	CITY.IRAN
PARINTINS	CITY.BRAZIL
TRAT	CITY.THAILAND
FORMOSA	CITY.BRAZIL
MANCHESTER	CITY.USA
LIMBÉ	CITY.CAMEROON
CHAUK	CITY.MYANMAR
KAIROUAN	CITY.TUNISIA
NOVOSHAKHTINSK	CITY.RUSSIA
MONTE GRANDE	CITY.ARGENTINA
QUÍBOR	CITY.VENEZUELA
ELGIN	CITY.USA
TUYÊN QUANG	CITY.VIETNAM
NAZILLI	CITY.TURKEY
FIROZPUR	CITY.INDIA
WEST JORDAN	CITY.USA
BARIPADA	CITY.INDIA
TORIDE	CITY.JAPAN
KAMAL SHAHR	CITY.IRAN
SIWAN	CITY.INDIA
BERNAL	CITY.ARGENTINA
IRINGA	CITY.TANZANIA
ROUND ROCK	CITY.USA
DESOUK	CITY.EGYPT
UBÁ	CITY.BRAZIL
NIĞDE	CITY.TURKEY
CLEARWATER	CITY.USA
WATERBURY	CITY.USA
MULHOUSE	CITY.FRANCE
RAJAMPET	CITY.INDIA
NOVOKUYBISHEVSK	CITY.RUSSIA
TSUYAMA	CITY.JAPAN
OURINHOS	CITY.BRAZIL
GITARAMA	CITY.RWANDA
BERGISCH GLADBACH	CITY.GERMANY
GRESHAM	CITY.USA
KANDY	CITY.SRI LANKA
FAIRFIELD	CITY.USA
SÃO LOURENÇO DA MATA	CITY.BRAZIL
KOMATSU	CITY.JAPAN
YEOJU	CITY.REPUBLIC OF KOREA
ACHINSK	CITY.RUSSIA
PUDUKKOTTAI	CITY.INDIA
ANG THONG	CITY.THAILAND
MIRYANG	CITY.REPUBLIC OF KOREA
ZONGULDAK	CITY.TURKEY
BILLINGS	CITY.USA
OURENSE	CITY.SPAIN
THAYETMYO	CITY.MYANMAR
REMSCHEID	CITY.GERMANY
CAEN	CITY.FRANCE
TUMBES	CITY.PERU
LOWELL	CITY.USA
BREMERHAVEN	CITY.GERMANY
CORONEL FABRICIANO	CITY.BRAZIL
VENTURA	CITY.USA
AÇAILÂNDIA	CITY.BRAZIL
ELISTA	CITY.RUSSIA
KARABÜK	CITY.TURKEY
KALISZ	CITY.POLAND
NOYABRSK	CITY.RUSSIA
MASCARA	CITY.ALGERIA
KIRŞEHIR	CITY.TURKEY
QALYUB	CITY.EGYPT
YASOOJ	CITY.IRAN
ANANTNAG	CITY.INDIA
CUAUTITLÁN	CITY.MEXICO
FARAH	CITY.AFGHANISTAN
EBOLOWA	CITY.CAMEROON
FORLÌ	CITY.ITALY
PUEBLO	CITY.USA
TADPATRI	CITY.INDIA
KOT ADDU	CITY.PAKISTAN
SAN CARLOS	CITY.VENEZUELA
DOULIU	CITY.TAIWAN
URASOE	CITY.JAPAN
SATARA	CITY.INDIA
OSIJEK	CITY.CROATIA
CORUMBÁ	CITY.BRAZIL
TINAQUILLO	CITY.VENEZUELA
SEROV	CITY.RUSSIA
KASUGA	CITY.JAPAN
NAZAR ABAD	CITY.IRAN
HIGH POINT	CITY.USA
WEST COVINA	CITY.USA
KOSZALIN	CITY.POLAND
JENA	CITY.GERMANY
SMEDEREVO	CITY.SERBIA
RICHMOND	CITY.USA
PIATRA NEAMŢ	CITY.ROMANIA
MURRIETA	CITY.USA
BEHBAHAN	CITY.IRAN
BHADRAK	CITY.INDIA
ELETS	CITY.RUSSIA
CARCAR	CITY.PHILIPPINES
UMUARAMA	CITY.BRAZIL
CAMBRIDGE	CITY.USA
SƠN LA	CITY.VIETNAM
TRIER	CITY.GERMANY
VICENZA	CITY.ITALY
BAM	CITY.IRAN
IIDA	CITY.JAPAN
ANTIOCH	CITY.USA
MONCTON	CITY.CANADA
KISHANGANJ	CITY.INDIA
ÖREBRO	CITY.SWEDEN
PLEVEN	CITY.BULGARIA
SUCEAVA	CITY.ROMANIA
TAITUNG	CITY.TAIWAN
CAUCASIA	CITY.COLOMBIA
SUDBURY	CITY.CANADA
SHOOSH	CITY.IRAN
SAINT-DENIS	CITY. SEINE-SAINT-DENIS	CITY.FRANCE
TEMECULA	CITY.USA
EXETER	CITY.UNITED KINGDOM
ALTAMIRA	CITY.BRAZIL
NAMUR	CITY.BELGIUM
KALLITHEA	CITY.GREECE
ALGECIRAS	CITY.SPAIN
TŌKAI	CITY.JAPAN
BHIMDUTTA	CITY.NEPAL
CHICOUTIMI-JONQUIÈRE	CITY.CANADA
NISHIO	CITY.JAPAN
CHINANDEGA	CITY.NICARAGUA
NORWALK	CITY.USA
MURIAÉ	CITY.BRAZIL
EASTBOURNE	CITY.UNITED KINGDOM
ZHUKOVSKY	CITY.RUSSIA
SURYAPET	CITY.INDIA
DROBETA-TURNU SEVERIN	CITY.ROMANIA
KECSKEMÉT	CITY.HUNGARY
VACOAS - PHOENIX	CITY.MAURITIUS
WARDHA	CITY.INDIA
HUALIEN	CITY.TAIWAN
RANEBENNURU	CITY.INDIA
CHARALLAVE	CITY.VENEZUELA
LEGNICA	CITY.POLAND
PUERTO AYACUCHO	CITY.VENEZUELA
EL LIMÓN	CITY.VENEZUELA
DEBRE ZEYIT	CITY.ETHIOPIA
ÇANAKKALE	CITY.TURKEY
CENTENNIAL	CITY.USA
BORYEONG	CITY.REPUBLIC OF KOREA
ABU KABIR	CITY.EGYPT
AMRELI	CITY.INDIA
IRIGA	CITY.PHILIPPINES
CEYHAN	CITY.TURKEY
HARTHA	CITY.IRAQ
TIPITAPA	CITY.NICARAGUA
OBNINSK	CITY.RUSSIA
NEYVELI	CITY.INDIA
WINTERTHUR	CITY.SWITZERLAND
KANOYA	CITY.JAPAN
KAFR EL-DAWWAR	CITY.EGYPT
ERLANGEN	CITY.GERMANY
CORONEL	CITY.CHILE
PATOS	CITY.BRAZIL
BIZERTE	CITY.TUNISIA
ARZAMAS	CITY.RUSSIA
CAICARA DEL ORINOCO	CITY.VENEZUELA
SUTTON COLDFIELD	CITY.UNITED KINGDOM
TUCURUÍ	CITY.BRAZIL
NANCY	CITY.FRANCE
PARAGOMINAS	CITY.BRAZIL
EVERETT	CITY.USA
FUJIMI	CITY.JAPAN
SAN JUSTO	CITY.ARGENTINA
BEAU BASSIN - ROSE HILL	CITY.MAURITIUS
LIBEREC	CITY.CZECH REPUBLIC
JAMALPUR	CITY.INDIA
TEXCOCO	CITY.MEXICO
SANCTI SPÍRITUS	CITY.CUBA
BLACKBURN	CITY.UNITED KINGDOM
TERNI	CITY.ITALY
KHUSHAB	CITY.PAKISTAN
GABES	CITY.TUNISIA
TRENTO	CITY.ITALY
LIGAO	CITY.PHILIPPINES
LAOAG	CITY.PHILIPPINES
NOVO GAMA	CITY.BRAZIL
PALM BAY	CITY.USA
WICHITA FALLS	CITY.USA
HIDALGO DEL PARRAL	CITY.MEXICO
FASA	CITY.IRAN
GREEN BAY	CITY.USA
MORMUGAO	CITY.INDIA
YARITAGUA	CITY.VENEZUELA
DALY CITY	CITY.USA
GIRGA	CITY.EGYPT
BURBANK	CITY.USA
SANGJU	CITY.REPUBLIC OF KOREA
PATTANI	CITY.THAILAND
FARIDPUR	CITY.BANGLADESH
KAMAGAYA	CITY.JAPAN
TRECE MARTIRES	CITY.PHILIPPINES
HARAR	CITY.ETHIOPIA
RICHARDSON	CITY.USA
AL-MANAGIL	CITY.SUDAN
AKHMIM	CITY.EGYPT
IKEDA	CITY.JAPAN
POMPANO BEACH	CITY.USA
COLCHESTER	CITY.UNITED KINGDOM
SOLIGORSK	CITY.BELARUS
CHAKWAL	CITY.PAKISTAN
SOHAR	CITY.OMAN
TIZI OUZOU	CITY.ALGERIA
LINKÖPING	CITY.SWEDEN
WAZIRABAD	CITY.PAKISTAN
TUCUPITA	CITY.VENEZUELA
UDGIR	CITY.INDIA
NORTH CHARLESTON	CITY.USA
DHANGADHI	CITY.NEPAL
SALTO	CITY.URUGUAY
PUSHKINO	CITY.RUSSIA
CASTELAR	CITY.ARGENTINA
PISCO	CITY.PERU
KAFANCHAN	CITY.NIGERIA
RAFAEL CASTILLO	CITY.ARGENTINA
ĐỒNG HỚI	CITY.VIETNAM
LIRA	CITY.UGANDA
TABUK	CITY.PHILIPPINES
NOGINSK	CITY.RUSSIA
GIRARDOT	CITY.COLOMBIA
CIÉNAGA	CITY.COLOMBIA
QUCHAN	CITY.IRAN
MUMBA	CITY.DEMOCRATIC REPUBLIC OF THE CONGO
FUJIMINO	CITY.JAPAN
HANAMAKI	CITY.JAPAN
KANUMA	CITY.JAPAN
LUXEMBOURG	CITY.LUXEMBOURG
TADEPALLIGUDEM	CITY.INDIA
OLDHAM	CITY.UNITED KINGDOM
BROKEN ARROW	CITY.USA
PORLAMAR	CITY.VENEZUELA
SHIBATA	CITY.JAPAN
ABECHE	CITY.CHAD
MASJED SOLEYMAN	CITY.IRAN
SAINT-PAUL	CITY.FRANCE
SZÉKESFEHÉRVÁR	CITY.HUNGARY
DOS HERMANAS	CITY.SPAIN
MIHARA	CITY.JAPAN
SANJŌ	CITY.JAPAN
YEONGCHEON	CITY.REPUBLIC OF KOREA
BOULDER	CITY.USA
ARGENTEUIL	CITY.FRANCE
MOERS	CITY.GERMANY
NOVOTROITSK	CITY.RUSSIA
CAMBÉ	CITY.BRAZIL
HIMAMAYLAN	CITY.PHILIPPINES
MATAREYA	CITY.EGYPT
OJIKWA	CITY.NIGERIA
ZURU	CITY.NIGERIA
KONTAGORA	CITY.NIGERIA
DERA ISMAIL KHAN	CITY.PAKISTAN
ABU AL-CHASIB	CITY.IRAQ
ZAXO	CITY.IRAQ
LODHRAN	CITY.PAKISTAN
LOWER HUTT	CITY.NEW ZEALAND
ARIQUEMES	CITY.BRAZIL
BAYBAY	CITY.PHILIPPINES
NAGAPATTINAM	CITY.INDIA
LUENA	CITY.ANGOLA
PIRAQUARA	CITY.BRAZIL
MONTREUIL	CITY.FRANCE
PUL-I-ALAM	CITY.AFGHANISTAN
ITUIUTABA	CITY.BRAZIL
TEPEXPAN	CITY.MEXICO
ST HELENS	CITY.UNITED KINGDOM
DIOURBEL	CITY.SENEGAL
BUXAR	CITY.INDIA
NYAUNGLEBIN	CITY.MYANMAR
AURANGABAD	CITY.INDIA
MEZHDURECHENSK	CITY.RUSSIA
JEHANABAD	CITY.INDIA
WEST PALM BEACH	CITY.USA
KASPIYSK	CITY.RUSSIA
TULANCINGO	CITY.MEXICO
LAHTI	CITY.FINLAND
AZUA	CITY.DOMINICAN REPUBLIC
NANTOU	CITY.TAIWAN
LENINSK-KUZNETSKY	CITY.RUSSIA
BACABAL	CITY.BRAZIL
PHAGWARA	CITY.INDIA
THUNDER BAY	CITY.CANADA
SANTA MARIA	CITY.USA
EL CAJON	CITY.USA
ERZINCAN	CITY.TURKEY
AKHISAR	CITY.TURKEY
DAVENPORT	CITY.USA
OLOMOUC	CITY.CZECH REPUBLIC
KHAIR	CITY.INDIA
TUBARÃO	CITY.BRAZIL
KAMIANETS-PODILSKYI	CITY.UKRAINE
KEFFI	CITY.NIGERIA
AGBOR	CITY.NIGERIA
SAWAI MADHOPUR	CITY.INDIA
SANTA ROSA	CITY.ARGENTINA
TETE	CITY.MOZAMBIQUE
TOBOLSK	CITY.RUSSIA
MAGADAN	CITY.RUSSIA
RIALTO	CITY.USA
OVORHANGAY	CITY.MONGOLIA
FARWANYIAH	CITY.KUWAIT
ESENTUKY	CITY.RUSSIA
SAN JUAN BAUTISTA TUXTEPEC	CITY.MEXICO
KANATA	CITY.CANADA
ERECHIM	CITY.BRAZIL
TARTU	CITY.ESTONIA
KAPURTHALA	CITY.INDIA
NAGA	CITY.PHILIPPINES
CHILAKALURIPET	CITY.INDIA
AURANGABAD	CITY.INDIA
S-HERTOGENBOSCH	CITY.NETHERLANDS
ALMADA	CITY.PORTUGAL
GAPAN	CITY.PHILIPPINES
EDISON	CITY.USA
GUIDER	CITY.CAMEROON
GBADOLITE	CITY.DEMOCRATIC REPUBLIC OF THE CONGO
MALAPPURAM	CITY.INDIA
LAS CRUCES	CITY.USA
LAGARTO	CITY.BRAZIL
LOS PUERTOS DE ALTAGRACIA	CITY.VENEZUELA
YOKOTE	CITY.JAPAN
KISELEVSK	CITY.RUSSIA
DIVO	CITY.CÔTE D'IVOIRE
ARAXÁ	CITY.BRAZIL
SAN MATEO	CITY.USA
AS SUWAYQ	CITY.OMAN
CAVITE CITY	CITY.PHILIPPINES
BAMBILI	CITY.CAMEROON
LEWISVILLE	CITY.USA
TORREJÓN DE ARDOZ	CITY.SPAIN
TANDIL	CITY.ARGENTINA
ASSIS	CITY.BRAZIL
NOVARA	CITY.ITALY
SOUTH BEND	CITY.USA
NOVOPOLOTSK	CITY.BELARUS
ISEHARA	CITY.JAPAN
IGUATU	CITY.BRAZIL
SATSUMASENDAI	CITY.JAPAN
LAKELAND	CITY.USA
DSCHĀZĀN	CITY.SAUDI-ARABIA
REWARI	CITY.INDIA
ERIE	CITY.USA
NAGAUR	CITY.INDIA
WOODBRIDGE	CITY.USA
NAZRAN	CITY.RUSSIA
SANTO ANTÔNIO DE JESUS	CITY.BRAZIL
CRAWLEY	CITY.UNITED KINGDOM
MOHAMMAD SHAHR	CITY.IRAN
ANCONA	CITY.ITALY
SAMANGAN	CITY.AFGHANISTAN
CIZRE	CITY.TURKEY
LIBERTAD	CITY.ARGENTINA
AL-QURAYYAT	CITY.SAUDI-ARABIA
LÜLEBURGAZ	CITY.TURKEY
SARH	CITY.CHAD
SŁUPSK	CITY.POLAND
SARAPYUL	CITY.RUSSIA
TYLER	CITY.USA
LASHKAR GAH	CITY.AFGHANISTAN
SAKU	CITY.JAPAN
KARADENIZ EREĞLI	CITY.TURKEY
PEARLAND	CITY.USA
SULTANPUR	CITY.INDIA
KŌNAN	CITY.JAPAN
SWABI	CITY.PAKISTAN
COLLEGE STATION	CITY.USA
NAGDA	CITY.INDIA
BOLZANO	CITY.ITALY