(Chicago)? Bears	TEAM.PROFESSIONAL_FOOTBALL
(San Francisco)? 49ers	TEAM.PROFESSIONAL_FOOTBALL
(Cincinnati)? Bengals	TEAM.PROFESSIONAL_FOOTBALL
(Buffalo)? Bills	TEAM.PROFESSIONAL_FOOTBALL
(Denver)? Broncos	TEAM.PROFESSIONAL_FOOTBALL
(Cleveland)? Browns	TEAM.PROFESSIONAL_FOOTBALL
(Tampa Bay)? Buccaneers	TEAM.PROFESSIONAL_FOOTBALL
(Arizona)? Cardinals	TEAM.PROFESSIONAL_FOOTBALL
(San Diego)? Chargers	TEAM.PROFESSIONAL_FOOTBALL
(Kansas City)? Chiefs	TEAM.PROFESSIONAL_FOOTBALL
(Indianapolis)? Colts	TEAM.PROFESSIONAL_FOOTBALL
(Dallas)? Cowboys	TEAM.PROFESSIONAL_FOOTBALL
(Miami)? Dolphins	TEAM.PROFESSIONAL_FOOTBALL
(Philadelphia)? Eagles	TEAM.PROFESSIONAL_FOOTBALL
(Atlanta)? Falcons	TEAM.PROFESSIONAL_FOOTBALL
(New York)? Giants	TEAM.PROFESSIONAL_FOOTBALL
(Jacksonville)? Jaguars	TEAM.PROFESSIONAL_FOOTBALL
(New York)? Jets	TEAM.PROFESSIONAL_FOOTBALL
(Detroit)? Lions	TEAM.PROFESSIONAL_FOOTBALL
(Green Bay)? Packers	TEAM.PROFESSIONAL_FOOTBALL
(Carolina)? Panthers	TEAM.PROFESSIONAL_FOOTBALL
(New England)? Patriots	TEAM.PROFESSIONAL_FOOTBALL
(Oakland)? Raiders	TEAM.PROFESSIONAL_FOOTBALL
(Los Angeles)? Rams	TEAM.PROFESSIONAL_FOOTBALL
(Baltimore)? Ravens	TEAM.PROFESSIONAL_FOOTBALL
(Washington)? Redskins	TEAM.PROFESSIONAL_FOOTBALL
(New Orleans)? Saints	TEAM.PROFESSIONAL_FOOTBALL
(Seattle)? Seahawks	TEAM.PROFESSIONAL_FOOTBALL
(Pittsburgh)? Steelers	TEAM.PROFESSIONAL_FOOTBALL
(Tennessee)? Titans	TEAM.PROFESSIONAL_FOOTBALL
(Minnesota)? Vikings	TEAM.PROFESSIONAL_FOOTBALL
(Atlanta)? Hawks	TEAM.PROFESIONAL_BASKETBALL
(Boston)? Celtics	TEAM.PROFESIONAL_BASKETBALL
(Charlotte)? Hornets	TEAM.PROFESIONAL_BASKETBALL
(Chicago)? Bulls	TEAM.PROFESIONAL_BASKETBALL
(Cleveland)? Cavaliers	TEAM.PROFESIONAL_BASKETBALL
(Dallas)? Mavericks	TEAM.PROFESIONAL_BASKETBALL
(Denver)? Nuggets	TEAM.PROFESIONAL_BASKETBALL
(Detroit)? Pistons	TEAM.PROFESIONAL_BASKETBALL
(Golden State)? Warriors	TEAM.PROFESIONAL_BASKETBALL
(Houston)? Rockets	TEAM.PROFESIONAL_BASKETBALL
(Indiana)? Pacers	TEAM.PROFESIONAL_BASKETBALL
(Los Angeles)? Clippers	TEAM.PROFESIONAL_BASKETBALL
(Los Angeles)? Lakers	TEAM.PROFESIONAL_BASKETBALL
(Miami)? Heat	TEAM.PROFESIONAL_BASKETBALL
(Milwaukee)? Bucks	TEAM.PROFESIONAL_BASKETBALL
(Minnesota)? Timberwolves	TEAM.PROFESIONAL_BASKETBALL
(New Jersey)? Nets	TEAM.PROFESIONAL_BASKETBALL
(New York)? Knicks	TEAM.PROFESIONAL_BASKETBALL
(Orlando)? Magic	TEAM.PROFESIONAL_BASKETBALL
(Philadelphia)? 76ers	TEAM.PROFESIONAL_BASKETBALL
(Phoenix)? Suns	TEAM.PROFESIONAL_BASKETBALL
(Portland)? Trail Blazers	TEAM.PROFESIONAL_BASKETBALL
(Sacramento)? Kings	TEAM.PROFESIONAL_BASKETBALL
(San Antonio)? Spurs	TEAM.PROFESIONAL_BASKETBALL
(Seattle)? Supersonics	TEAM.PROFESIONAL_BASKETBALL
(Toronto)? Raptors	TEAM.PROFESIONAL_BASKETBALL
(Utah)? Jazz	TEAM.PROFESIONAL_BASKETBALL
(Vancouver)? Grizzlies	TEAM.PROFESIONAL_BASKETBALL
(Washington)? Wizards	TEAM.PROFESIONAL_BASKETBALL
(Washington)? Bullets	TEAM.PROFESIONAL_BASKETBALL
(Anaheim)? Angels	TEAM.PROFESSIONAL_BASEBALL
(Arizona)? Diamondbacks	TEAM.PROFESSIONAL_BASEBALL
(Atlanta)? Braves	TEAM.PROFESSIONAL_BASEBALL
(Baltimore)? Orioles	TEAM.PROFESSIONAL_BASEBALL
(Boston)? Red Sox	TEAM.PROFESSIONAL_BASEBALL
(Chicago)? Cubs	TEAM.PROFESSIONAL_BASEBALL
(Chicago)? White Sox	TEAM.PROFESSIONAL_BASEBALL
(Cincinnati)? Reds	TEAM.PROFESSIONAL_BASEBALL
(Cleveland)? Indians	TEAM.PROFESSIONAL_BASEBALL
(Colorado)? Rockies	TEAM.PROFESSIONAL_BASEBALL
(Detroit)? Tigers	TEAM.PROFESSIONAL_BASEBALL
(Florida)? Marlins	TEAM.PROFESSIONAL_BASEBALL
(Houston)? Astros	TEAM.PROFESSIONAL_BASEBALL
(Kansas City)? Royals	TEAM.PROFESSIONAL_BASEBALL
(Los Angeles)? Dodgers	TEAM.PROFESSIONAL_BASEBALL
(Milwaukee)? Brewers	TEAM.PROFESSIONAL_BASEBALL
(Minnesota)? Twins	TEAM.PROFESSIONAL_BASEBALL
(Montreal)? Expos	TEAM.PROFESSIONAL_BASEBALL
(New York)? Mets	TEAM.PROFESSIONAL_BASEBALL
(New York)? Yankees	TEAM.PROFESSIONAL_BASEBALL
(Oakland)? Athletics	TEAM.PROFESSIONAL_BASEBALL
(Philadelphia)? Phillies	TEAM.PROFESSIONAL_BASEBALL
(Pittsburgh)? Pirates	TEAM.PROFESSIONAL_BASEBALL
(San Diego)? Padres	TEAM.PROFESSIONAL_BASEBALL
(San Francisco)? Giants	TEAM.PROFESSIONAL_BASEBALL
(Seattle)? Mariners	TEAM.PROFESSIONAL_BASEBALL
(St Louis)? Cardinals	TEAM.PROFESSIONAL_BASEBALL
(Tampa Bay)? Devil Rays	TEAM.PROFESSIONAL_BASEBALL
(Texas)? Rangers	TEAM.PROFESSIONAL_BASEBALL
(Toronto)? Blue Jays	TEAM.PROFESSIONAL_BASEBALL
(Anaheim)? Mighty Ducks	TEAM.PROFESSIONAL_HOCKEY
(Boston)? Bruins	TEAM.PROFESSIONAL_HOCKEY
(Buffalo)? Sabres	TEAM.PROFESSIONAL_HOCKEY
(Calgary)? Flames	TEAM.PROFESSIONAL_HOCKEY
(Carolina)? Hurricanes	TEAM.PROFESSIONAL_HOCKEY
(Chicago)? Blackhawks	TEAM.PROFESSIONAL_HOCKEY
(Colorado)? Avalanche	TEAM.PROFESSIONAL_HOCKEY
(Dallas)? Stars	TEAM.PROFESSIONAL_HOCKEY
(Detroit)? Red Wings	TEAM.PROFESSIONAL_HOCKEY
(Edmonton)? Oilers	TEAM.PROFESSIONAL_HOCKEY
(Florida)? Panthers	TEAM.PROFESSIONAL_HOCKEY
(Hartford)? Whalers	TEAM.PROFESSIONAL_HOCKEY
(Los Angeles)? Kings	TEAM.PROFESSIONAL_HOCKEY
(Montreal)? Canadiens	TEAM.PROFESSIONAL_HOCKEY
(Nashville)? Predators	TEAM.PROFESSIONAL_HOCKEY
(New Jersey)? Devils	TEAM.PROFESSIONAL_HOCKEY
(New York)? Islanders	TEAM.PROFESSIONAL_HOCKEY
(New York)? Rangers	TEAM.PROFESSIONAL_HOCKEY
(Ottawa)? Senators	TEAM.PROFESSIONAL_HOCKEY
(Philadelphia)? Flyers	TEAM.PROFESSIONAL_HOCKEY
(Phoenix)? Coyotes	TEAM.PROFESSIONAL_HOCKEY
(Pittsburgh)? Penguins	TEAM.PROFESSIONAL_HOCKEY
(Quebec)? Nordiques	TEAM.PROFESSIONAL_HOCKEY
(San Jose)? Sharks	TEAM.PROFESSIONAL_HOCKEY
(St Louis)? Blues	TEAM.PROFESSIONAL_HOCKEY
(Tampa Bay)? Lightning	TEAM.PROFESSIONAL_HOCKEY
(Toronto)? Maple Leafs	TEAM.PROFESSIONAL_HOCKEY
(Vancouver)? Canucks	TEAM.PROFESSIONAL_HOCKEY
(Washington)? Capitals	TEAM.PROFESSIONAL_HOCKEY
(Winnipeg)? Jets	TEAM.PROFESSIONAL_HOCKEY
(Chicago)? Fire	TEAM.PROFESSIONAL_SOCCER
(Colorado)? Rapids	TEAM.PROFESSIONAL_SOCCER
(Columbus)? Crew	TEAM.PROFESSIONAL_SOCCER
(D.C.)? United	TEAM.PROFESSIONAL_SOCCER
(Dallas)? Burn	TEAM.PROFESSIONAL_SOCCER
(Houston)? Dynamo	TEAM.PROFESSIONAL_SOCCER
(Kansas City)? Sporting	TEAM.PROFESSIONAL_SOCCER
(Los Angeles)? Galaxy	TEAM.PROFESSIONAL_SOCCER
(Montreal)? Impact	TEAM.PROFESSIONAL_SOCCER
(New England)? Revolution	TEAM.PROFESSIONAL_SOCCER
(New York)? Red Bulls	TEAM.PROFESSIONAL_SOCCER
(Philadelphia)? Union	TEAM.PROFESSIONAL_SOCCER
(Portland)? Timbers	TEAM.PROFESSIONAL_SOCCER
(Salt Lake)? Real	TEAM.PROFESSIONAL_SOCCER
(San Jose)? Earthquakes	TEAM.PROFESSIONAL_SOCCER
(Seattle)? Sounders	TEAM.PROFESSIONAL_SOCCER
(Toronto)? FC	TEAM.PROFESSIONAL_SOCCER
(Vancouver)? Whitecaps	TEAM.PROFESSIONAL_SOCCER
