Artichoke	VEGETABLE
Arugula	VEGETABLE
Asparagus	VEGETABLE
Aubergine	VEGETABLE
Eggplant	VEGETABLE
Amaranth	VEGETABLE
Alfalfa sprouts	VEGETABLE.LEGUME
Azuki beans	VEGETABLE.LEGUME
Bean sprouts	VEGETABLE.LEGUME
Black beans	VEGETABLE.LEGUME
Black-eyed peas	VEGETABLE.LEGUME
Borlotti bean	VEGETABLE.LEGUME
Broad beans	VEGETABLE.LEGUME
Chickpeas	VEGETABLE.LEGUME
Garbanzos	VEGETABLE.LEGUME
ceci beans	VEGETABLE.LEGUME
Green beans	VEGETABLE.LEGUME
Kidney beans	VEGETABLE.LEGUME
Lentils	VEGETABLE.LEGUME
Lima beans	VEGETABLE.LEGUME
Butter bean	VEGETABLE.LEGUME
Mung beans	VEGETABLE.LEGUME
Navy beans	VEGETABLE.LEGUME
Pinto beans	VEGETABLE.LEGUME
Runner beans	VEGETABLE.LEGUME
Split peas	VEGETABLE.LEGUME
Soy beans	VEGETABLE.LEGUME
Peas	VEGETABLE.LEGUME
Mangetout	VEGETABLE.LEGUME
Snap peas	VEGETABLE.LEGUME
Beet greens	VEGETABLE
Bok choy	VEGETABLE
Broccoflower	VEGETABLE
Broccoli	VEGETABLE
Brussels sprouts	VEGETABLE
Cabbage	VEGETABLE
Calabrese	VEGETABLE
Carrots	VEGETABLE
Cauliflower	VEGETABLE
Celery	VEGETABLE
Chard	VEGETABLE
Collard greens	VEGETABLE
Corn salad	VEGETABLE
Endive	VEGETABLE
Fiddleheads	VEGETABLE
Frisee	VEGETABLE
Fennel	VEGETABLE
Anise	VEGETABLE.HERB
Basil	VEGETABLE.HERB
Caraway	VEGETABLE.HERB
Cilantro	VEGETABLE.HERB
Coriander	VEGETABLE.HERB
Chamomile	VEGETABLE.HERB
Dill	VEGETABLE.HERB
Fennel	VEGETABLE.HERB
Lavender	VEGETABLE.HERB
Lemon Grass	VEGETABLE.HERB
Marjoram	VEGETABLE.HERB
Oregano	VEGETABLE.HERB
Parsley	VEGETABLE.HERB
Rosemary	VEGETABLE.HERB
Sage	VEGETABLE.HERB
Thyme	VEGETABLE.HERB
Kale	VEGETABLE
Kohlrabi	VEGETABLE
Lettuce Lactuca sativa	VEGETABLE
Maize	VEGETABLE
Sweetcorn	VEGETABLE
Mushrooms	VEGETABLE
Mustard greens	VEGETABLE
Nettles	VEGETABLE
New Zealand spinach	VEGETABLE
Okra	VEGETABLE
Chives	VEGETABLE.ONION
Garlic	VEGETABLE.ONION
Leek Allium porrum	VEGETABLE.ONION
Onion	VEGETABLE.ONION
Shallot	VEGETABLE.ONION
Spring onion	VEGETABLE.ONION
Green onion	VEGETABLE.ONION
Scallion	VEGETABLE.ONION
Parsley	VEGETABLE
Pepper	VEGETABLE.PEPPER
Green pepper 	VEGETABLE.PEPPER
Red pepper	VEGETABLE.PEPPER
bell pepper	VEGETABLE.PEPPER
pimento	VEGETABLE.PEPPER
Chili pepper	VEGETABLE.PEPPER
Capsicum	VEGETABLE.PEPPER
Jalape�o	VEGETABLE.PEPPER
Habanero	VEGETABLE.PEPPER
Paprika	VEGETABLE.PEPPER
Tabasco pepper	VEGETABLE.PEPPER
Cayenne pepper	VEGETABLE.PEPPER
Radicchio	VEGETABLE
Rhubarb	VEGETABLE
Beetroot	VEGETABLE
Beet 	VEGETABLE
mangel-wurzel	VEGETABLE
Carrot	VEGETABLE
Celeriac	VEGETABLE
Daikon	VEGETABLE
Ginger	VEGETABLE
Parsnip	VEGETABLE
Rutabaga	VEGETABLE
Turnip	VEGETABLE
Radish	VEGETABLE
Swede	VEGETABLE
Rutabaga	VEGETABLE
Turnip	VEGETABLE
Wasabi	VEGETABLE
Horseradish	VEGETABLE
White radish	VEGETABLE
Salsify	VEGETABLE
Purple Salsify	VEGETABLE
Oyster Plant	VEGETABLE
Skirret	VEGETABLE
Spinach	VEGETABLE
Topinambur	VEGETABLE
Squashes	VEGETABLE.SQUASH
Acorn squash	VEGETABLE.SQUASH
Butternut squash	VEGETABLE.SQUASH
Banana squash	VEGETABLE.SQUASH
Courgette	VEGETABLE.SQUASH
Zucchini	VEGETABLE.SQUASH
Cucumber	VEGETABLE.SQUASH
Delicata	VEGETABLE.SQUASH
Gem squash	VEGETABLE.SQUASH
Hubbard squash	VEGETABLE.SQUASH
Marrow	VEGETABLE.SQUASH
Squash	VEGETABLE.SQUASH
Patty pans	VEGETABLE.SQUASH
Pumpkin	VEGETABLE.SQUASH
Spaghetti squash	VEGETABLE.SQUASH
Tat soi	VEGETABLE
Tomato	VEGETABLE
Tubers	VEGETABLE
Jicama	VEGETABLE
Jerusalem artichoke	VEGETABLE
Potato	VEGETABLE
Sunchokes	VEGETABLE
Sweet potato	VEGETABLE
Taro	VEGETABLE
Yam	VEGETABLE
Turnip greens	VEGETABLE
Water chestnut	VEGETABLE
Watercress	VEGETABLE
Zucchini	VEGETABLE
