Agung a Tamlang	MUSICAL-INSTRUMENT.PERCUSSION
Bamboo slit drum	MUSICAL-INSTRUMENT.PERCUSSION
Balafon	MUSICAL-INSTRUMENT.PERCUSSION
Cajon	MUSICAL-INSTRUMENT.PERCUSSION
Castanet	MUSICAL-INSTRUMENT.PERCUSSION
Clapstick	MUSICAL-INSTRUMENT.PERCUSSION
Glockenspiel	MUSICAL-INSTRUMENT.PERCUSSION
Handpan	MUSICAL-INSTRUMENT.PERCUSSION
Mbira	MUSICAL-INSTRUMENT.PERCUSSION
Marimba	MUSICAL-INSTRUMENT.PERCUSSION
Stellpan	MUSICAL-INSTRUMENT.PERCUSSION
Triangle	MUSICAL-INSTRUMENT.PERCUSSION
Vibraphone	MUSICAL-INSTRUMENT.PERCUSSION
Wood block	MUSICAL-INSTRUMENT.PERCUSSION
Xylophone	MUSICAL-INSTRUMENT.PERCUSSION
Agida	MUSICAL-INSTRUMENT.MEMBRANOPHONES
Alcahuete	MUSICAL-INSTRUMENT.MEMBRANOPHONES
Apinti	MUSICAL-INSTRUMENT.MEMBRANOPHONES
Arobap�	MUSICAL-INSTRUMENT.MEMBRANOPHONES
Ashiko	MUSICAL-INSTRUMENT.MEMBRANOPHONES
Assotor	MUSICAL-INSTRUMENT.MEMBRANOPHONES
Baboula	MUSICAL-INSTRUMENT.MEMBRANOPHONES
Balaban	MUSICAL-INSTRUMENT.MEMBRANOPHONES
Balsi�	MUSICAL-INSTRUMENT.MEMBRANOPHONES
Bamboula	MUSICAL-INSTRUMENT.MEMBRANOPHONES
Bari	MUSICAL-INSTRUMENT.MEMBRANOPHONES
Barrel drum	MUSICAL-INSTRUMENT.MEMBRANOPHONES
Barriles	MUSICAL-INSTRUMENT.MEMBRANOPHONES
Bass drum	MUSICAL-INSTRUMENT.MEMBRANOPHONES
Bodhran	MUSICAL-INSTRUMENT.MEMBRANOPHONES
Bongo drums	MUSICAL-INSTRUMENT.MEMBRANOPHONES
Boodam	MUSICAL-INSTRUMENT.MEMBRANOPHONES
Candombe	MUSICAL-INSTRUMENT.MEMBRANOPHONES
Chenda	MUSICAL-INSTRUMENT.MEMBRANOPHONES
Conga	MUSICAL-INSTRUMENT.MEMBRANOPHONES
Cuica	MUSICAL-INSTRUMENT.MEMBRANOPHONES
Dabakan	MUSICAL-INSTRUMENT.MEMBRANOPHONES
Daf	MUSICAL-INSTRUMENT.MEMBRANOPHONES
Davul	MUSICAL-INSTRUMENT.MEMBRANOPHONES
Dhaa	MUSICAL-INSTRUMENT.MEMBRANOPHONES
Dhimay	MUSICAL-INSTRUMENT.MEMBRANOPHONES
Dhol	MUSICAL-INSTRUMENT.MEMBRANOPHONES
Dholak	MUSICAL-INSTRUMENT.MEMBRANOPHONES
Dimdi	MUSICAL-INSTRUMENT.MEMBRANOPHONES
Djembe	MUSICAL-INSTRUMENT.MEMBRANOPHONES
Dollu	MUSICAL-INSTRUMENT.MEMBRANOPHONES
Dunun	MUSICAL-INSTRUMENT.MEMBRANOPHONES
Drum kit	MUSICAL-INSTRUMENT.MEMBRANOPHONES
Gran Cassa	MUSICAL-INSTRUMENT.MEMBRANOPHONES
Goblet drum	MUSICAL-INSTRUMENT.MEMBRANOPHONES
Hira-daiko	MUSICAL-INSTRUMENT.MEMBRANOPHONES
Ilimba drum	MUSICAL-INSTRUMENT.MEMBRANOPHONES
Ingoma	MUSICAL-INSTRUMENT.MEMBRANOPHONES
Janggu	MUSICAL-INSTRUMENT.MEMBRANOPHONES
Kakko	MUSICAL-INSTRUMENT.MEMBRANOPHONES
Kanjira	MUSICAL-INSTRUMENT.MEMBRANOPHONES
Kendang	MUSICAL-INSTRUMENT.MEMBRANOPHONES
Khol	MUSICAL-INSTRUMENT.MEMBRANOPHONES
Lambeg drum	MUSICAL-INSTRUMENT.MEMBRANOPHONES
Madhalam	MUSICAL-INSTRUMENT.MEMBRANOPHONES
Madal	MUSICAL-INSTRUMENT.MEMBRANOPHONES
Maddale	MUSICAL-INSTRUMENT.MEMBRANOPHONES
Maktoum	MUSICAL-INSTRUMENT.MEMBRANOPHONES
Mridangam	MUSICAL-INSTRUMENT.MEMBRANOPHONES
Naqara	MUSICAL-INSTRUMENT.MEMBRANOPHONES
Naqareh	MUSICAL-INSTRUMENT.MEMBRANOPHONES
O-daiko	MUSICAL-INSTRUMENT.MEMBRANOPHONES
Okedo-daiko	MUSICAL-INSTRUMENT.MEMBRANOPHONES
Octaban	MUSICAL-INSTRUMENT.MEMBRANOPHONES
Pakhavaj	MUSICAL-INSTRUMENT.MEMBRANOPHONES
Pandero	MUSICAL-INSTRUMENT.MEMBRANOPHONES
Piccolo snare	MUSICAL-INSTRUMENT.MEMBRANOPHONES
Sabar	MUSICAL-INSTRUMENT.MEMBRANOPHONES
Samphor	MUSICAL-INSTRUMENT.MEMBRANOPHONES
Shime-jishi daiko	MUSICAL-INSTRUMENT.MEMBRANOPHONES
Snare	MUSICAL-INSTRUMENT.MEMBRANOPHONES
Surdo	MUSICAL-INSTRUMENT.MEMBRANOPHONES
Tabla	MUSICAL-INSTRUMENT.MEMBRANOPHONES
Taiko	MUSICAL-INSTRUMENT.MEMBRANOPHONES
Talking drum	MUSICAL-INSTRUMENT.MEMBRANOPHONES
Tsukeshime-daiko	MUSICAL-INSTRUMENT.MEMBRANOPHONES
Tsuzumi	MUSICAL-INSTRUMENT.MEMBRANOPHONES
Tambor huacana	MUSICAL-INSTRUMENT.MEMBRANOPHONES
Tamboril	MUSICAL-INSTRUMENT.MEMBRANOPHONES
Tamborita	MUSICAL-INSTRUMENT.MEMBRANOPHONES
Tambou bas a d� fas	MUSICAL-INSTRUMENT.MEMBRANOPHONES
Tambou bas a yon fas	MUSICAL-INSTRUMENT.MEMBRANOPHONES
Tan-tan	MUSICAL-INSTRUMENT.MEMBRANOPHONES
Taphon	MUSICAL-INSTRUMENT.MEMBRANOPHONES
Thavil	MUSICAL-INSTRUMENT.MEMBRANOPHONES
Timpani	MUSICAL-INSTRUMENT.MEMBRANOPHONES
kettledrum	MUSICAL-INSTRUMENT.MEMBRANOPHONES
Tom-tom	MUSICAL-INSTRUMENT.MEMBRANOPHONES
Tombak	MUSICAL-INSTRUMENT.MEMBRANOPHONES
Repique	MUSICAL-INSTRUMENT.MEMBRANOPHONES
Uchiwa-daiko	MUSICAL-INSTRUMENT.MEMBRANOPHONES
Accordola	MUSICAL-INSTRUMENT.WIND
Air horn	MUSICAL-INSTRUMENT.WIND
Alboka	MUSICAL-INSTRUMENT.WIND
Alphorn	MUSICAL-INSTRUMENT.WIND
Alto horn	MUSICAL-INSTRUMENT.WIND
Arghul	MUSICAL-INSTRUMENT.WIND
Atenteben	MUSICAL-INSTRUMENT.WIND
Bagpipe	MUSICAL-INSTRUMENT.WIND
Balaban	MUSICAL-INSTRUMENT.WIND
Bandone�n	MUSICAL-INSTRUMENT.WIND
Bansuri	MUSICAL-INSTRUMENT.WIND
Baritone horn	MUSICAL-INSTRUMENT.WIND
Baritone voice	MUSICAL-INSTRUMENT.WIND
Bassoon	MUSICAL-INSTRUMENT.WIND
Bawu	MUSICAL-INSTRUMENT.WIND
Bayan	MUSICAL-INSTRUMENT.WIND
Bazooka	MUSICAL-INSTRUMENT.WIND
Beatboxing	MUSICAL-INSTRUMENT.WIND
Bifora	MUSICAL-INSTRUMENT.WIND
Blul	MUSICAL-INSTRUMENT.WIND
Bombarde	MUSICAL-INSTRUMENT.WIND
Buccina	MUSICAL-INSTRUMENT.WIND
Bugle	MUSICAL-INSTRUMENT.WIND
Bullroarer	MUSICAL-INSTRUMENT.WIND
Calliope	MUSICAL-INSTRUMENT.WIND
Castrato	MUSICAL-INSTRUMENT.WIND
Chalumeau	MUSICAL-INSTRUMENT.WIND
Cimbasso	MUSICAL-INSTRUMENT.WIND
Clarinets	MUSICAL-INSTRUMENT.WIND
Clarytone	MUSICAL-INSTRUMENT.WIND
Concertina	MUSICAL-INSTRUMENT.WIND
Conch	MUSICAL-INSTRUMENT.WIND
Cornamuse	MUSICAL-INSTRUMENT.WIND
Cornet	MUSICAL-INSTRUMENT.WIND
Cornett	MUSICAL-INSTRUMENT.WIND
Cornu	MUSICAL-INSTRUMENT.WIND
Corrugaphone	MUSICAL-INSTRUMENT.WIND
Countertenor	MUSICAL-INSTRUMENT.WIND
Cromorne	MUSICAL-INSTRUMENT.WIND
Crumhorn	MUSICAL-INSTRUMENT.WIND
Danso	MUSICAL-INSTRUMENT.WIND
Death growl	MUSICAL-INSTRUMENT.WIND
Didgeridoo	MUSICAL-INSTRUMENT.WIND
Diple 	MUSICAL-INSTRUMENT.WIND
dvojnice	MUSICAL-INSTRUMENT.WIND
Dizi	MUSICAL-INSTRUMENT.WIND
Double bell euphonium	MUSICAL-INSTRUMENT.WIND
Doulophone	MUSICAL-INSTRUMENT.WIND
Cuprophone	MUSICAL-INSTRUMENT.WIND
Duduk	MUSICAL-INSTRUMENT.WIND
Dulcian	MUSICAL-INSTRUMENT.WIND
Dulzaina	MUSICAL-INSTRUMENT.WIND
Dung-Dkar	MUSICAL-INSTRUMENT.WIND
Dzhamara	MUSICAL-INSTRUMENT.WIND
English horn	MUSICAL-INSTRUMENT.WIND
Euphonium	MUSICAL-INSTRUMENT.WIND
Falsetto	MUSICAL-INSTRUMENT.WIND
Fife	MUSICAL-INSTRUMENT.WIND
Firebird (trumpet)	MUSICAL-INSTRUMENT.WIND
Fiscorn	MUSICAL-INSTRUMENT.WIND
Flabiol	MUSICAL-INSTRUMENT.WIND
Flageolet	MUSICAL-INSTRUMENT.WIND
Flatt trumpet	MUSICAL-INSTRUMENT.WIND
Flugelhorn	MUSICAL-INSTRUMENT.WIND
Flumpet	MUSICAL-INSTRUMENT.WIND
Flutina	MUSICAL-INSTRUMENT.WIND
Flute	MUSICAL-INSTRUMENT.WIND
Folgerphone	MUSICAL-INSTRUMENT.WIND
French horn	MUSICAL-INSTRUMENT.WIND
Fujara	MUSICAL-INSTRUMENT.WIND
Gaida	MUSICAL-INSTRUMENT.WIND
Garmon	MUSICAL-INSTRUMENT.WIND
Gemshorn	MUSICAL-INSTRUMENT.WIND
Gralla	MUSICAL-INSTRUMENT.WIND
Guan	MUSICAL-INSTRUMENT.WIND
Hano	MUSICAL-INSTRUMENT.WIND
Harmoneon	MUSICAL-INSTRUMENT.WIND
Harmonica	MUSICAL-INSTRUMENT.WIND
Harmonium	MUSICAL-INSTRUMENT.WIND
Heckelphone	MUSICAL-INSTRUMENT.WIND
Helicon	MUSICAL-INSTRUMENT.WIND
Horagai	MUSICAL-INSTRUMENT.WIND
Hosaphone	MUSICAL-INSTRUMENT.WIND
Hotchiku	MUSICAL-INSTRUMENT.WIND
Hulusi	MUSICAL-INSTRUMENT.WIND
Hun	MUSICAL-INSTRUMENT.WIND
Inci	MUSICAL-INSTRUMENT.WIND
Irish flute	MUSICAL-INSTRUMENT.WIND
Jug	MUSICAL-INSTRUMENT.WIND
Kagurabue	MUSICAL-INSTRUMENT.WIND
Kalaleng	MUSICAL-INSTRUMENT.WIND
Kaval	MUSICAL-INSTRUMENT.WIND
Kazoo	MUSICAL-INSTRUMENT.WIND
Key bugle	MUSICAL-INSTRUMENT.WIND
Khene	MUSICAL-INSTRUMENT.WIND
Khloy	MUSICAL-INSTRUMENT.WIND
Khlui	MUSICAL-INSTRUMENT.WIND
Komabue	MUSICAL-INSTRUMENT.WIND
Koncovka	MUSICAL-INSTRUMENT.WIND
Kortholt	MUSICAL-INSTRUMENT.WIND
Koudi	MUSICAL-INSTRUMENT.WIND
Kuhlohorn	MUSICAL-INSTRUMENT.WIND
Launeddas	MUSICAL-INSTRUMENT.WIND
Livenka	MUSICAL-INSTRUMENT.WIND
Lusheng	MUSICAL-INSTRUMENT.WIND
Mangtong	MUSICAL-INSTRUMENT.WIND
Lituus	MUSICAL-INSTRUMENT.WIND
Mellophone	MUSICAL-INSTRUMENT.WIND
Melodica	MUSICAL-INSTRUMENT.WIND
Melodeon	MUSICAL-INSTRUMENT.WIND
Mezzo-soprano	MUSICAL-INSTRUMENT.WIND
Mijwiz	MUSICAL-INSTRUMENT.WIND
Mizmar	MUSICAL-INSTRUMENT.WIND
Musette de cour	MUSICAL-INSTRUMENT.WIND
Nadaswaram	MUSICAL-INSTRUMENT.WIND
Nagak	MUSICAL-INSTRUMENT.WIND
Ncas	MUSICAL-INSTRUMENT.WIND
Ney	MUSICAL-INSTRUMENT.WIND
Nguru	MUSICAL-INSTRUMENT.WIND
Nohkan	MUSICAL-INSTRUMENT.WIND
Nose flute	MUSICAL-INSTRUMENT.WIND
Nplooj	MUSICAL-INSTRUMENT.WIND
Oboe	MUSICAL-INSTRUMENT.WIND
Ocarina	MUSICAL-INSTRUMENT.WIND
Octavin	MUSICAL-INSTRUMENT.WIND
Ophicleide	MUSICAL-INSTRUMENT.WIND
Paixiao	MUSICAL-INSTRUMENT.WIND
Palendag	MUSICAL-INSTRUMENT.WIND
Pan flute	MUSICAL-INSTRUMENT.WIND
Pasiyak	MUSICAL-INSTRUMENT.WIND
water whistle	MUSICAL-INSTRUMENT.WIND
Pavari	MUSICAL-INSTRUMENT.WIND
Pibgorn	MUSICAL-INSTRUMENT.WIND
Picco pipe	MUSICAL-INSTRUMENT.WIND
Piccolo	MUSICAL-INSTRUMENT.WIND
Piccolo trumpet	MUSICAL-INSTRUMENT.WIND
Pipe organ	MUSICAL-INSTRUMENT.WIND
Reed pipes	MUSICAL-INSTRUMENT.WIND
Pitch pipe	MUSICAL-INSTRUMENT.WIND
Pocket cornet	MUSICAL-INSTRUMENT.WIND
Pocket trumpet	MUSICAL-INSTRUMENT.WIND
Post horn	MUSICAL-INSTRUMENT.WIND
Pu	MUSICAL-INSTRUMENT.WIND
Pulalu	MUSICAL-INSTRUMENT.WIND
Qeej	MUSICAL-INSTRUMENT.WIND
Quena	MUSICAL-INSTRUMENT.WIND
Quinticlave	MUSICAL-INSTRUMENT.WIND
Raj	MUSICAL-INSTRUMENT.WIND
Rackett	MUSICAL-INSTRUMENT.WIND
Rapping	MUSICAL-INSTRUMENT.WIND
Rauschpfeife	MUSICAL-INSTRUMENT.WIND
Recorder	MUSICAL-INSTRUMENT.WIND
Reed contrabass	MUSICAL-INSTRUMENT.WIND
Reed organ	MUSICAL-INSTRUMENT.WIND
Rhaita	MUSICAL-INSTRUMENT.WIND
Robero	MUSICAL-INSTRUMENT.WIND
Roman tuba	MUSICAL-INSTRUMENT.WIND
Ryuteki	MUSICAL-INSTRUMENT.WIND
Saenghwang	MUSICAL-INSTRUMENT.WIND
Sackbut	MUSICAL-INSTRUMENT.WIND
Samponia	MUSICAL-INSTRUMENT.WIND
Saratovskaya garmonika	MUSICAL-INSTRUMENT.WIND
Sarrusophones	MUSICAL-INSTRUMENT.WIND
Saxophones	MUSICAL-INSTRUMENT.WIND
Saxhorn	MUSICAL-INSTRUMENT.WIND
Saxotromba	MUSICAL-INSTRUMENT.WIND
Saxtuba	MUSICAL-INSTRUMENT.WIND
Scat singing	MUSICAL-INSTRUMENT.WIND
Schwyzer�rgeli	MUSICAL-INSTRUMENT.WIND
Serpent	MUSICAL-INSTRUMENT.WIND
Shakuhachi	MUSICAL-INSTRUMENT.WIND
Shankha	MUSICAL-INSTRUMENT.WIND
Shawm	MUSICAL-INSTRUMENT.WIND
Shehnai	MUSICAL-INSTRUMENT.WIND
Sheng	MUSICAL-INSTRUMENT.WIND
Shinobue	MUSICAL-INSTRUMENT.WIND
Shofar	MUSICAL-INSTRUMENT.WIND
Shvi	MUSICAL-INSTRUMENT.WIND
Siku	MUSICAL-INSTRUMENT.WIND
Siren	MUSICAL-INSTRUMENT.WIND
Slide trumpet	MUSICAL-INSTRUMENT.WIND
Slide whistle	MUSICAL-INSTRUMENT.WIND
Sodina	MUSICAL-INSTRUMENT.WIND
Sopila	MUSICAL-INSTRUMENT.WIND
Soprano	MUSICAL-INSTRUMENT.WIND
Sorna	MUSICAL-INSTRUMENT.WIND
Sousaphone	MUSICAL-INSTRUMENT.WIND
Sralai	MUSICAL-INSTRUMENT.WIND
Sudrophone	MUSICAL-INSTRUMENT.WIND
Suling	MUSICAL-INSTRUMENT.WIND
Suona	MUSICAL-INSTRUMENT.WIND
Superbone	MUSICAL-INSTRUMENT.WIND
Swordblade	MUSICAL-INSTRUMENT.WIND
Tabor pipe	MUSICAL-INSTRUMENT.WIND
Taepyeongso	MUSICAL-INSTRUMENT.WIND
Tarogato	MUSICAL-INSTRUMENT.WIND
Tenor	MUSICAL-INSTRUMENT.WIND
Tenora	MUSICAL-INSTRUMENT.WIND
Throat singing	MUSICAL-INSTRUMENT.WIND
Tible	MUSICAL-INSTRUMENT.WIND
Tin whistle	MUSICAL-INSTRUMENT.WIND
Toasting	MUSICAL-INSTRUMENT.WIND
Tonette	MUSICAL-INSTRUMENT.WIND
Trikiti	MUSICAL-INSTRUMENT.WIND
Trombones	MUSICAL-INSTRUMENT.WIND
Tromboon	MUSICAL-INSTRUMENT.WIND
Trompeta china	MUSICAL-INSTRUMENT.WIND
Trumpets	MUSICAL-INSTRUMENT.WIND
Tuba	MUSICAL-INSTRUMENT.WIND
Tube trumpet	MUSICAL-INSTRUMENT.WIND
Tumpong	MUSICAL-INSTRUMENT.WIND
Tungso	MUSICAL-INSTRUMENT.WIND
Tutek	MUSICAL-INSTRUMENT.WIND
Txistu	MUSICAL-INSTRUMENT.WIND
Uilleann pipes	MUSICAL-INSTRUMENT.WIND
Venu	MUSICAL-INSTRUMENT.WIND
Vibrandoneon	MUSICAL-INSTRUMENT.WIND
Vienna horn	MUSICAL-INSTRUMENT.WIND
Vocal percussion	MUSICAL-INSTRUMENT.WIND
Vuvuzela	MUSICAL-INSTRUMENT.WIND
Wagner tuba	MUSICAL-INSTRUMENT.WIND
Washint	MUSICAL-INSTRUMENT.WIND
Western concert flutes	MUSICAL-INSTRUMENT.WIND
Whip	MUSICAL-INSTRUMENT.WIND
Whistle	MUSICAL-INSTRUMENT.WIND
Willow flute	MUSICAL-INSTRUMENT.WIND
Xiao	MUSICAL-INSTRUMENT.WIND
Xun	MUSICAL-INSTRUMENT.WIND
Yodel	MUSICAL-INSTRUMENT.WIND
Yotar	MUSICAL-INSTRUMENT.WIND
Yu	MUSICAL-INSTRUMENT.WIND
Zhaleika	MUSICAL-INSTRUMENT.WIND
Zufolo	MUSICAL-INSTRUMENT.WIND
Zugtrompette	MUSICAL-INSTRUMENT.WIND
Zurna	MUSICAL-INSTRUMENT.WIND
Aeolian harp	MUSICAL-INSTRUMENT.STRING
Ajaeng	MUSICAL-INSTRUMENT.STRING
Appalachian dulcimer	MUSICAL-INSTRUMENT.STRING
Archlute	MUSICAL-INSTRUMENT.STRING
Arpeggione	MUSICAL-INSTRUMENT.STRING
Autoharp	MUSICAL-INSTRUMENT.STRING
Baglama	MUSICAL-INSTRUMENT.STRING
Balalaika	MUSICAL-INSTRUMENT.STRING
Bandol�n	MUSICAL-INSTRUMENT.STRING
Bandura	MUSICAL-INSTRUMENT.STRING
Bandurria	MUSICAL-INSTRUMENT.STRING
Banjo	MUSICAL-INSTRUMENT.STRING
Banjo mandolin	MUSICAL-INSTRUMENT.STRING
Banjo ukulele	MUSICAL-INSTRUMENT.STRING
Barbat	MUSICAL-INSTRUMENT.STRING
Baryton	MUSICAL-INSTRUMENT.STRING
Berimbau	MUSICAL-INSTRUMENT.STRING
Biwa	MUSICAL-INSTRUMENT.STRING
Bordonua	MUSICAL-INSTRUMENT.STRING
Bouzouki	MUSICAL-INSTRUMENT.STRING
Cavaquinho	MUSICAL-INSTRUMENT.STRING
Clavinet	MUSICAL-INSTRUMENT.STRING
Chapman stick	MUSICAL-INSTRUMENT.STRING
Charangos	MUSICAL-INSTRUMENT.STRING
Cimbalom	MUSICAL-INSTRUMENT.STRING
Cuatro	MUSICAL-INSTRUMENT.STRING
Citole	MUSICAL-INSTRUMENT.STRING
Cittern	MUSICAL-INSTRUMENT.STRING
Clavichord	MUSICAL-INSTRUMENT.STRING
Crwth	MUSICAL-INSTRUMENT.STRING
Cuatro	MUSICAL-INSTRUMENT.STRING
Dahu	MUSICAL-INSTRUMENT.STRING
Diddley bow	MUSICAL-INSTRUMENT.STRING
Dihu	MUSICAL-INSTRUMENT.STRING
Dombra	MUSICAL-INSTRUMENT.STRING
Domra	MUSICAL-INSTRUMENT.STRING
Double-neck guitjo	MUSICAL-INSTRUMENT.STRING
Double bass	MUSICAL-INSTRUMENT.STRING
Dutar	MUSICAL-INSTRUMENT.STRING
Duxianqin	MUSICAL-INSTRUMENT.STRING
Ektara	MUSICAL-INSTRUMENT.STRING
Erhu	MUSICAL-INSTRUMENT.STRING
Erxian	MUSICAL-INSTRUMENT.STRING
Esraj	MUSICAL-INSTRUMENT.STRING
Faglong/Fuglung	MUSICAL-INSTRUMENT.STRING
Fegereng	MUSICAL-INSTRUMENT.STRING
Fiddle	MUSICAL-INSTRUMENT.STRING
Gayageum	MUSICAL-INSTRUMENT.STRING
Gehu	MUSICAL-INSTRUMENT.STRING
Geomungo	MUSICAL-INSTRUMENT.STRING
Gittern	MUSICAL-INSTRUMENT.STRING
Gopuz	MUSICAL-INSTRUMENT.STRING
Gottuvadhyam	MUSICAL-INSTRUMENT.STRING
Guitar	MUSICAL-INSTRUMENT.STRING
Baritone Guitar	MUSICAL-INSTRUMENT.STRING
Bass guitar	MUSICAL-INSTRUMENT.STRING
Chitarra battente	MUSICAL-INSTRUMENT.STRING
Cigar box guitar	MUSICAL-INSTRUMENT.STRING
Classical guitar	MUSICAL-INSTRUMENT.STRING
Electric guitar	MUSICAL-INSTRUMENT.STRING
Electric Bass Guitar	MUSICAL-INSTRUMENT.STRING
Extended Range Guitar	MUSICAL-INSTRUMENT.STRING
Flamenco guitar	MUSICAL-INSTRUMENT.STRING
Fusetar	MUSICAL-INSTRUMENT.STRING
Guitarra quinta huapanguera	MUSICAL-INSTRUMENT.STRING
Guitar synthesizer	MUSICAL-INSTRUMENT.STRING
Guitarr�n	MUSICAL-INSTRUMENT.STRING
Guitarr�n	MUSICAL-INSTRUMENT.STRING
Gut-stringed Guitar	MUSICAL-INSTRUMENT.STRING
Lap Steel Guitar	MUSICAL-INSTRUMENT.STRING
Multi-necked Guitar	MUSICAL-INSTRUMENT.STRING
Nine-string Guitar	MUSICAL-INSTRUMENT.STRING
Nylon-stringed Guitar	MUSICAL-INSTRUMENT.STRING
Octave Guitar	MUSICAL-INSTRUMENT.STRING
Resophonic Guitar	MUSICAL-INSTRUMENT.STRING
Steel-Stringed Guitar	MUSICAL-INSTRUMENT.STRING
Tenor Guitar	MUSICAL-INSTRUMENT.STRING
Terz Guitar	MUSICAL-INSTRUMENT.STRING
Twelve-string Guitar	MUSICAL-INSTRUMENT.STRING
Yotar	MUSICAL-INSTRUMENT.STRING
Gusli	MUSICAL-INSTRUMENT.STRING
Guqin	MUSICAL-INSTRUMENT.STRING
Guzheng	MUSICAL-INSTRUMENT.STRING
Haegeum	MUSICAL-INSTRUMENT.STRING
Hammered Dulcimer	MUSICAL-INSTRUMENT.STRING
Hardanger fiddle	MUSICAL-INSTRUMENT.STRING
Harmonico	MUSICAL-INSTRUMENT.STRING
Harp	MUSICAL-INSTRUMENT.STRING
Harpsichord	MUSICAL-INSTRUMENT.STRING
Hegelong	MUSICAL-INSTRUMENT.STRING
Huluhu	MUSICAL-INSTRUMENT.STRING
Huqin	MUSICAL-INSTRUMENT.STRING
Hurdy-gurdy	MUSICAL-INSTRUMENT.STRING
Igil	MUSICAL-INSTRUMENT.STRING
Irish bouzouki	MUSICAL-INSTRUMENT.STRING
Jarana de son jarocho	MUSICAL-INSTRUMENT.STRING
Jarana huasteca	MUSICAL-INSTRUMENT.STRING
Jarana mosquito	MUSICAL-INSTRUMENT.STRING
Jarana segunda	MUSICAL-INSTRUMENT.STRING
Jarana tercera	MUSICAL-INSTRUMENT.STRING
Jiaohu	MUSICAL-INSTRUMENT.STRING
Kabosy	MUSICAL-INSTRUMENT.STRING
Kadlong	MUSICAL-INSTRUMENT.STRING
Kamancha	MUSICAL-INSTRUMENT.STRING
Kantele	MUSICAL-INSTRUMENT.STRING
Kemenche	MUSICAL-INSTRUMENT.STRING
Khim	MUSICAL-INSTRUMENT.STRING
Kobza	MUSICAL-INSTRUMENT.STRING
Kokles	MUSICAL-INSTRUMENT.STRING
Komungo	MUSICAL-INSTRUMENT.STRING
Kora	MUSICAL-INSTRUMENT.STRING
Koto	MUSICAL-INSTRUMENT.STRING
Kubing	MUSICAL-INSTRUMENT.STRING
Kudyapi	MUSICAL-INSTRUMENT.STRING
Langeleik	MUSICAL-INSTRUMENT.STRING
Laruan	MUSICAL-INSTRUMENT.STRING
Leiqin	MUSICAL-INSTRUMENT.STRING
Lirone	MUSICAL-INSTRUMENT.STRING
Lokanga	MUSICAL-INSTRUMENT.STRING
Lute	MUSICAL-INSTRUMENT.STRING
Lyre	MUSICAL-INSTRUMENT.STRING
Maguhu	MUSICAL-INSTRUMENT.STRING
Mandola	MUSICAL-INSTRUMENT.STRING
Mando-bass	MUSICAL-INSTRUMENT.STRING
Mandocello	MUSICAL-INSTRUMENT.STRING
Mandolin	MUSICAL-INSTRUMENT.STRING
Mandora	MUSICAL-INSTRUMENT.STRING
Mandore	MUSICAL-INSTRUMENT.STRING
Marovany	MUSICAL-INSTRUMENT.STRING
Mohan veena	MUSICAL-INSTRUMENT.STRING
Morin khuur	MUSICAL-INSTRUMENT.STRING
Musical bow	MUSICAL-INSTRUMENT.STRING
Nyckelharpa	MUSICAL-INSTRUMENT.STRING
Octobass	MUSICAL-INSTRUMENT.STRING
Oud	MUSICAL-INSTRUMENT.STRING
Piano	MUSICAL-INSTRUMENT.STRING
Pipa	MUSICAL-INSTRUMENT.STRING
Piwancha	MUSICAL-INSTRUMENT.STRING
Portuguese guitar	MUSICAL-INSTRUMENT.STRING
Psaltery	MUSICAL-INSTRUMENT.STRING
Ravanahatha	MUSICAL-INSTRUMENT.STRING
Rebab	MUSICAL-INSTRUMENT.STRING
Rebec	MUSICAL-INSTRUMENT.STRING
Requinto jarocho	MUSICAL-INSTRUMENT.STRING
Ruan	MUSICAL-INSTRUMENT.STRING
Rudra vina	MUSICAL-INSTRUMENT.STRING
Sallameh	MUSICAL-INSTRUMENT.STRING
Sanshin	MUSICAL-INSTRUMENT.STRING
Santoor	MUSICAL-INSTRUMENT.STRING
Sanxian	MUSICAL-INSTRUMENT.STRING
Sarangi	MUSICAL-INSTRUMENT.STRING
Sarod	MUSICAL-INSTRUMENT.STRING
Saung	MUSICAL-INSTRUMENT.STRING
Saw sam sai	MUSICAL-INSTRUMENT.STRING
Saz	MUSICAL-INSTRUMENT.STRING
Se	MUSICAL-INSTRUMENT.STRING
Shamisen	MUSICAL-INSTRUMENT.STRING
Setar	MUSICAL-INSTRUMENT.STRING
Sitar	MUSICAL-INSTRUMENT.STRING
Sitarla	MUSICAL-INSTRUMENT.STRING
Stroh violin	MUSICAL-INSTRUMENT.STRING
Sopranino mandolin	MUSICAL-INSTRUMENT.STRING
Tamburitza	MUSICAL-INSTRUMENT.STRING
Tanpura	MUSICAL-INSTRUMENT.STRING
lute	MUSICAL-INSTRUMENT.STRING
Tea chest bass	MUSICAL-INSTRUMENT.STRING
Temb�r	MUSICAL-INSTRUMENT.STRING
Theorbo	MUSICAL-INSTRUMENT.STRING
Timple	MUSICAL-INSTRUMENT.STRING
Tres	MUSICAL-INSTRUMENT.STRING
Tro	MUSICAL-INSTRUMENT.STRING
Trumpet marine	MUSICAL-INSTRUMENT.STRING
tromba marina	MUSICAL-INSTRUMENT.STRING
Tsymbaly	MUSICAL-INSTRUMENT.STRING
Tuhu	MUSICAL-INSTRUMENT.STRING
Ukulele	MUSICAL-INSTRUMENT.STRING
Valiha	MUSICAL-INSTRUMENT.STRING
Veena	MUSICAL-INSTRUMENT.STRING
Vertical viola	MUSICAL-INSTRUMENT.STRING
Vichitra vina	MUSICAL-INSTRUMENT.STRING
Vielle	MUSICAL-INSTRUMENT.STRING
Vihuela	MUSICAL-INSTRUMENT.STRING
Vihuela	MUSICAL-INSTRUMENT.STRING
Viol	MUSICAL-INSTRUMENT.STRING
Viola	MUSICAL-INSTRUMENT.STRING
Viola da gamba	MUSICAL-INSTRUMENT.STRING
Viola de Arame	MUSICAL-INSTRUMENT.STRING
Viola organista	MUSICAL-INSTRUMENT.STRING
Viola da Terra	MUSICAL-INSTRUMENT.STRING
Viola da Terceira	MUSICAL-INSTRUMENT.STRING
Violin	MUSICAL-INSTRUMENT.STRING
Violotta	MUSICAL-INSTRUMENT.STRING
Washtub bass	MUSICAL-INSTRUMENT.STRING
Whamola	MUSICAL-INSTRUMENT.STRING
Wheelharp	MUSICAL-INSTRUMENT.STRING
Xalam/Khalam	MUSICAL-INSTRUMENT.STRING
Xenorphica	MUSICAL-INSTRUMENT.STRING
tanbur	MUSICAL-INSTRUMENT.STRING
Yazheng	MUSICAL-INSTRUMENT.STRING
Yangqin	MUSICAL-INSTRUMENT.STRING
Zhonghu	MUSICAL-INSTRUMENT.STRING
Zhuihu	MUSICAL-INSTRUMENT.STRING
Zither	MUSICAL-INSTRUMENT.STRING
